abandon	abandon
abandonment	abandon
abatement	abate
abidance	abide
abolition	abolish
abolishment	abolish
abortion	abort
absence	absent
absentee	absent
absenteeism	absent
absolute	absolve
absolver	absolve
absolution	absolve
absolutism	absolve
absoluteness	absolve
absorber	absorb
absorbent	absorb
absorbate	absorb
absorbency	absorb
absorption	absorb
absorptance	absorb
absorptivity	absorb
abstainer	abstain
abstinent	abstain
abstention	abstain
abstinence	abstain
abuse	abuse
abuser	abuse
accelerator	accelerate
acceleration	accelerate
accent	accent	accentuate
accentor	accent	accentuate
accenting	accent	accentuate
accentuation	accent	accentuate
acceptor	accept
acceptance	accept
acceptation	accept
acceptability	accept
acceptableness	accept
access	access	accession
accession	access	accession
accessibility	access	accession
accommodation	accommodate
accompanist	accompany
accompanyist	accompany
accompaniment	accompany
accomplishment	accomplish
accord	accord
accordion	accord
accordance	accord
account	account
accounting	account
accountant	account
accountancy	account
accountability	account
accrual	accrue
accrument	accrue
accruement	accrue
accumulator	accumulate
accumulation	accumulate
accusal	accuse
accused	accuse
accuser	accuse
accusation	accuse
accusative	accuse
achiever	achieve
achievement	achieve
achievability	achieve
acknowldgement	acknowledge
acknowledgment	acknowledge
acknowledgement	acknowledge
acquiescence	acquiesce
acquirer	acquire
acquiring	acquire
acquirement	acquire
acquisition	acquire
acquisitiveness	acquire
act	act
acts	act
actor	act
acting	act
actress	act
action	activate
active	activate
activity	activate
activator	activate
activating	activate
activation	activate
activeness	activate
adapter	adapt
adaptor	adapt
adaptation	adapt
adaptability	adapt
adder	add
addition	add
additive	add
address	address
addressee	address
adherent	adhere
adhesion	adhere
adhesive	adhere
adherence	adhere
adhesiveness	adhere
adjournment	adjourn
adjuster	adjust
adjustor	adjust
adjustment	adjust
administrator	administer
administration	administer
admission	admit
admittance	admit
admissibility	admit
adoption	adopt
advance	advance
advancement	advance
advantage	advantage
advantageousness	advantage
adventure	adventure
adventurer	adventure
adventurism	adventure
adventurousness	adventure
advice	advise
advisee	advise
adviser	advise
advisor	advise
advisory	advise
advisement	advise
advisability	advise
advocacy	advocate
advocate	advocate
advocation	advocate
affect	affect
affection	affect
affectation	affect
affectionateness	affect
affiliate	affiliate
affiliation	affiliate
aggravation	aggravate
aggregate	aggregate
aggregation	aggregate
agreement	agree
aid	aid
aide	aid
aids	aid
aides	aid
aim	aim
air	air
aire	air
airs	air
airing	air
airman	air
airship	air
alarm	alarm
alarmism	alarm
alarmist	alarm
alert	alert
alerting	alert
alertness	alert
alien	alien
alienism	alien
alienation	alien
alignment	align
allegation	allege
allegement	allege
alleviation	alleviate
allocation	allocate
allowance	allow	allowance
alloy	alloy
ally	ally
allis	ally
allies	ally
alliance	ally
altering	alter
alteration	alter
alterability	alter
alternant	alternate
alternate	alternate
alternator	alternate
alternation	alternate
alternative	alternate
amassment	amass
amends	amend
amendment	amend
amnesty	amnesty
amount	amount
analyser	analyze
analysis	analyze
analyzer	analyze
analyticity	analyze
analyzation	analyze
anchor	anchor
anchorage	anchor
anchorite	anchor
anchorman	anchor
anger	anger
angriness	anger
angle	angle
angler	angle
angling	angle
angularity	angle
announcer	announce
anunciation	announce
announcement	announce
annulment	annul
answer	answer
answerer	answer
answerability	answer
answerableness	answer
antagonist	antagonise	antagonize
antagonism	antagonise	antagonize
antagonisation	antagonise	antagonize
antagonization	antagonise	antagonize
anticipation	anticipate
apparel	apparel
appeal	appeal
appellant	appeal
appellation	appeal
appellative	appeal
appearing	appear
appearance	appear
appeaser	appease
appeasement	appease
applier	apply
applicant	apply
appliance	apply
applicator	apply
application	apply
applicability	apply
appointee	appoint
appiontment	appoint
appointment	appoint
appreciation	appreciate
appreciativeness	appreciate
approach	approach
approaching	approach
approachability	approach
appropriation	appropriate
appropriateness	appropriate
approval	approve
approving	approve
approximant	approximate
approximation	approximate
arbitrage	arbitrage
arbitrager	arbitrage
arbitrator	arbitrate
arbitrament	arbitrate
arbitration	arbitrate
arbitrement	arbitrate
arc	arc
argus	argue
arguer	argue
arguing	argue
argument	argue
argumentation	argue
arm	arm
arms	arm
armor	arm
armful	arm
arming	arm
armorer	arm
armament	arm
arranger	arrange
arranging	arrange
arrangement	arrange
array	array
arrayal	array
arrest	arrest
arrester	arrest
arrival	arrive
arriver	arrive
article	article
ascertainment	ascertain
ash	ash
asker	ask
asking	ask
assault	assault
assay	assay
assayal	assay
assertion	assert
asserttion	assert
assertiveness	assert
assess	assess
assessor	assess
assessment	assess
assignee	assign
assigning	assign
assignment	assign
assignation	assign
assist	assist
assistant	assist
assistance	assist
associate	associate
association	associate
associability	associate
associableness	associate
assumption	assume
assur	assure
assurance	assure
ation	protest
protest	protest
protester	protest
protestant	protest
protestation	protest
attache	attach
attachment	attach
attack	attack
attacker	attack
attainment	attain
attainability	attain
attainableness	attain
attempt	attempt
attender	attend
attention	attend
attendant	attend
attending	attend
attendance	attend
attentiveness	attend
attraction	attract
attractiveness	attract
attribute	attribute
attribution	attribute
auction	auction
auctioneer	auction
audit	audit
auditor	audit
audition	audit
augmentation	augment
augur	augur
augury	augur
author	author	authorise	authorize
authority	author	authorise	authorize
authorities	author	authorise	authorize
authoritarian	author	authorise	authorize
authorisation	author	authorise	authorize
authorization	author	authorise	authorize
authoritarianism	author	authorise	authorize
automobile	automobile
avail	avail
availability	avail
availableness	avail
avalanche	avalanche
averment	aver
average	average
averageness	average
aversion	avert
averting	avert
avoidance	avoid
award	award
awarding	award
ax	axe
axe	axe
baby	baby
back	back
backer	back
backing	back
background	background
backgrounding	background
backlash	backlash
backlog	backlog
backstop	backstop
bag	bag
bagful	bag
bagman	bag
baggage	bag
bagging	bag
bai	bay
bay	bay
bayer	bay
bail	bail
bailment	bail
balance	balance
balancer	balance
balancing	balance
ball	ball
ballast	ballast
balloon	balloon
ballooning	balloon
balloonist	balloon
ballot	ballot
balloting	ballot
ban	ban
banning	ban
band	band
banding	band
bang	bang
banger	bang
banging	bang
bank	bank
banker	bank
banking	bank
bankrupt	bankrupt
bankruptcy	bankrupt
banquet	banquet
banqueting	banquet
bar	bar
bars	bar
barman	bar
barring	bar
barite	bare
baring	bare
bareness	bare
bargain	bargain
bargainer	bargain
bargaining	bargain
barge	barge
bargee	barge
bargeman	barge
barrage	barrage
barrel	barrel
barrels	barrel
barrelful	barrel
barter	barter
barterer	barter
base	base
baseness	base
batch	batch
bath	bath
bathe	bath
bather	bath
bathing	bath
batter	batter
battery	batter
battering	batter
battle	battle
battler	battle
battlement	battle
battleship	battle
bayonet	bayonet
be	be
being	be
beach	beach
bear	bear
bearer	bear
bearing	bear
beat	beat
beater	beat
beating	beat
bed	bed
bedding	bed
bedevilment	bedevil
beef	beef
beetle	beetle
beggar	beg	beggar
beggary	beg	beggar
begging	beg	beggar
beggarman	beg	beggar
beginning	begin
belief	believe
believer	believe
believing	believe
believability	believe
bell	bell
belle	bell
belling	bell
bellman	bell
belly	belly
bellis	belly
bellyful	belly
belonging	belong
belongings	belong
belt	belt
belting	belt
benefit	benefit
benefaction	benefit
berth	berth
best	best
bet	bet
better	better
betterment	better
bias	bias
bicycle	bicycle
bicycling	bicycle
bicyclist	bicycle
bid	bid
bidding	bid
bill	bill
billing	bill
billion	bill
billings	bill
billions	bill
billet	billet
bin	bin
binful	bin
bind	bind
binder	bind
bindery	bind
binding	bind
bird	bird
birding	bird
bite	bite
biter	bite
bitter	bitter
bitters	bitter
bitterness	bitter
black	black
blacking	black
blackness	black
blame	blame
blanket	blanket
blast	blast
blaze	blaze
blazer	blaze
blazing	blaze
blend	blend
blende	blend
blender	blend
blending	blend
blind	blind
blinder	blind
blindness	blind
block	block
blocker	block
blockage	block
blocking	block
blockade	blockade
blood	blood
bloom	bloom
blooming	bloom
blow	blow
blower	blow
blowing	blow
bludgeon	bludgeon
blue	blue
blues	blue
blueing	blue
blueness	blue
blueprint	blueprint
bluntness	blunt
board	board
boards	board
boarder	board
boarding	board
boat	boat
boater	boat
boating	boat
boatman	boat
boding	bode
bodement	bode
body	body
boil	boil
boiler	boil
boiling	boil
bolster	bolster
bomb	bomb
bomber	bomb
bombast	bomb
bombing	bomb
bond	bond
bonding	bond
bondman	bond
bone	bone
boner	bone
bones	bone
boniness	bone
book	book
booker	book
booking	book
boom	boom
boomer	boom
boomerang	boomerang
boost	boost
booster	boost
boosters	boost
boot	boot
bootee	boot
bootes	boot
bootees	boot
border	border
borderer	border
bore	bore
borer	bore
boring	bore
boredom	bore
borrower	borrow
borrowing	borrow
bother	bother
botheration	bother
bottle	bottle
bottleful	bottle
bottleneck	bottleneck
bottom	bottom
bounce	bounce
bouncer	bounce
bouncing	bounce
bounciness	bounce
bound	bound
bounds	bound
bounder	bound
boundary	bound
bow	bow
bower	bow
bowman	bow
bowing	bow
box	box
boxer	box
boxful	box
boxing	box
boycott	boycott
brake	brake
brakes	brake
brakeman	brake
branch	branch
branching	branch
embranchment	branch
brand	brand
branding	brand
brave	brave
bravery	brave
braving	brave
breach	breach
broach	breach
bread	bread
break	break
breaker	break
breakage	break
breakers	break
breaking	break
breakfast	breakfast
breast	breast
breath	breathe
breather	breathe
breathing	breathe
brew	brew
brewer	brew
brewage	brew
brewery	brew
brewing	brew
bribe	bribe
briber	bribe
bribery	bribe
bridge	bridge
brief	brief
briefs	brief
brevity	brief
briefing	brief
briefness	brief
bringing	bring
briskness	brisk
broadcast	broadcast
broadcaster	broadcast
broadcasting	broadcast
broadening	broaden
broker	broker
brown	brown
browning	brown
brownness	brown
bubble	bubble
bubbly	bubble
bubbler	bubble
buck	buck
bud	bud
budding	bud
budget	budget
buffer	buffer
bug	bug
build	build
builder	build
building	build
bulk	bulk
bull	bull
bullion	bull
bulletin	bulletin
bunch	bunch
bunk	bunker
bunker	bunker
buoy	buoy
buoyant	buoy
buoyancy	buoy
burden	burden
burdensomeness	burden
burial	bury
burier	bury
burying	bury
burst	burst
burster	burst
bus	bus
buss	bus
busful	bus
busman	bus
bussing	bus
bush	bush
bushing	bush
bushel	bushel
bust	bust
buster	bust
busying	busy
business	busy
busyness	busy
butter	butter
buy	buy
buyer	buy
buying	buy
bypass	bypass
cable	cable
cake	cake
calculator	calculate
calculation	calculate
calculability	calculate
calendar	calendar
calender	calender
call	call
caller	call
calling	call
calm	calm
calming	calm
calmness	calm
camp	camp
camper	camp
camping	camp
campion	camp
campaign	campaign
campaigner	campaign
campaigning	campaign
can	can
canful	can
cannery	can
canning	can
cancel	cancel
cancellation	cancel
cane	cane	canal
canal	cane	canal
caning	cane	canal
canalisation	cane	canal
canalization	cane	canal
canvass	canvass
canvasser	canvass
canvassing	canvass
cap	cap
capful	cap
caption	cap
capital	capitalize
capitate	capitalize
capitalism	capitalize
capitalist	capitalize
capitation	capitalize
capitalization	capitalize
capitalisation	capitalise
captain	captain
captaincy	captain
captainship	captain
capture	capture
card	card
cards	card
care	care
caring	care
carefulness	care
career	career
careerism	career
careerist	career
carpet	carpet
carpeting	carpet
carry	carry
carrier	carry
carriage	carry
case	case
casing	case
caseful	case
casement	case
cash	cash
cast	cast
caste	cast
caster	cast
castor	cast
casting	cast
cat	cat
catalog	catalog
cataloger	catalog
catalogue	catalogue
cataloguer	catalogue
catch	catch
catcher	catch
catching	catch
catchment	catch
category	category
categorisation	category
categorization	category
caterer	cater
catering	cater
cause	cause
causing	cause
causation	cause
caution	caution
cease	cease
cessation	cease
ceding	cede
cession	cede
celebrant	celebrate
celebrity	celebrate
celebrater	celebrate
celebrator	celebrate
celebration	celebrate
cement	cement
cementite	cement
cementation	cement
censure	censure
census	census
center	center	centre
centre	center	centre
central	center	centre
centred	center	centre
centrist	center	centre
centroid	center	centre
centering	center	centre
centrality	center	centre
centralisation	center	centre
centralization	center	centre
centigrade	centigrade
certificate	certify	certificate
certification	certify	certificate
chain	chain
chains	chain
chair	chair	chairman
chairman	chair	chairman
challenge	challenge
challenger	challenge
chamber	chamber
chance	chance
chang	change
change	change
changer	change
changefulness	change
channel	channel
channels	channel
channelization	channel
character	character	characterize
characterization	character	characterize
charge	charge
charger	charge
chart	chart
chartism	chart
chartist	chart
charter	charter
charterage	charter
chase	chase
chased	chase
chaser	chase
cheat	cheat
cheater	cheat
cheating	cheat
check	check
checker	check
checkers	check
cheese	cheese
chill	chill
chilling	chill
chip	chip
chipping	chip
choice	choose
chosen	choose
choiceness	choose
choke	choke
choker	choke
choking	choke
chrome	chrome
chunk	chunk
circle	circle
circular	circle
circularity	circle
circularisation	circle
circularization	circle
circuit	circuit
circulant	circulate
circulation	circulate
circumvent	circumvent
circumvention	circumvent
citation	cite
claim	claim
claimant	claim
clarification	clarify
clash	clash
class	class
classifier	classify
classification	classify
clean	clean
cleaner	clean
cleaning	clean
cleaners	clean
cleanness	clean
cleanliness	clean
clear	clear
clearing	clear
clearance	clear
clearness	clear
climb	climb
climber	climb
climbing	climb
clinch	clinch
clincher	clinch
clock	clock
clocks	clock
clocking	clock
clone	clone
close	close	closure
closing	close	closure
closure	close	closure
cloture	close	closure
closeness	close	closure
cloud	cloud	clouded
clouding	cloud	clouded
clout	clout
club	club
clubbing	club
clutch	clutch
clutches	clutch
coal	coal
coalman	coal
coast	coast
coaster	coast
coat	coat
coatee	coat
coating	coat
code	code
coding	code
coffin	coffin
coil	coil
coin	coin
coiner	coin
coinage	coin
coincidence	coincide
coke	coke
collapse	collapse
collect	collect
collector	collect
collecting	collect
collection	collect
collective	collect
color	color
colors	color
colored	color
coloring	color
coloration	color
colour	colour
colours	colour
colouring	colour
combat	combat
combatant	combat
combine	combine
combining	combine
combinator	combine
combination	combine
comer	come
coming	come
comfort	comfort	comfortable
comforts	comfort	comfortable
comforter	comfort	comfortable
comfortableness	comfort	comfortable
command	command
commander	command
commandant	command
commandeer	command
commandment	command
commemoration	commemorate
commencement	commence
comment	comment
commentary	comment
commentator	comment
commentation	comment
commercial	commercialize
commercialism	commercialize
commercialisation	commercialize
commercialization	commercialize
committal	commit	commission
commission	commit	commission
commitment	commit	commission
commissioner	commit	commission
commissioning	commit	commission
communicant	communicate
communicator	communicate
communication	communicate
communicating	communicate
communicativeness	communicate
compact	compact
compaction	compact
compactness	compact
companion	companion
companionship	companion
companionability	companion
companionableness	companion
company	company
compare	compare
comparing	compare
comparator	compare
comparison	compare
comparative	compare
comparability	compare
compass	compass
compassion	compass
compassionateness	compass
compulsion	compel
compulsive	compel
compulsivity	compel
compulsiveness	compel
compensation	compensate
competence	compete
competency	compete
competition	compete
competitiveness	compete
complaint	complain
complainer	complain
complainant	complain
complement	complement
complementation	complement
completion	complete
completeness	complete
compliment	compliment
compliments	compliment
compliance	comply
compliancy	comply
compound	compound
compounding	compound
comprehension	comprehend
comprehensibility	comprehend
comprehensiveness	comprehend
comprisal	comprise
comprising	comprise
compromise	compromise
computer	compute
computation	compute
concealing	conceal
concealment	conceal
conceding	concede
concession	concede
concentrate	concentrate
concentration	concentrate
concentricity	concentrate
concert	concert
conclusion	conclude
conclusiveness	conclude
concrete	concrete
concretion	concrete
concretism	concrete
concreteness	concrete
concretisation	concrete
concretization	concrete
concern	concern
condemnation	condemn
condenser	condensate
condensate	condensate
condensing	condensate
condensation	condensate
condition	condition
conditioner	condition
conditioning	condition
conditionality	condition
conduct	conduct
conductor	conduct
conduction	conduct
conducting	conduct
conductance	conduct
conductivity	conduct
conferee	confer
conferral	confer
conference	confer
conferment	confer
confines	confine
confinement	confine
confirmation	confirm
conflict	conflict
confliction	conflict
conformism	conform
conformist	conform
conformity	conform
conformance	conform
conformation	conform
confronting	confront
confrontment	confront
confrontation	confront
conglomerate	conglomerate
conglomeration	conglomerate
conjecture	conjecture
connecter	connect
connector	connect
connection	connect
connecting	connect
connective	connect
consent	consent
consensus	consent
conserve	conserve
conserves	conserve
conserving	conserve
conservancy	conserve
conservator	conserve
conservation	conserve
conservative	conserve
consideration	consider
considerateness	consider
consistence	consist
consistency	consist
consolidation	consolidate
consitution	constitute
constitution	constitute
constitutional	constitute
constraint	constrain
construct	construct	structure
structure	construct	structure
constructor	construct	structure
construction	construct	structure
structuralism	construct	structure
constructiveness	construct	structure
structuralization	construct	structure
consultant	consult
consultation	consult
consumer	consume
consumption	consume
consumptive	consume
consummation	consummate
contact	contact
contacting	contact
container	contain
containment	contain
containerful	contain
contemplation	contemplate
contemplativeness	contemplate
content	contend	content
contents	contend	content
contender	contend	content
contention	contend	content
contentment	contend	content
contentiousness	contend	content
contest	contest
contestant	contest
contestation	contest
continuant	continue
continuity	continue
continuance	continue
continuation	continue
continuousness	continue
contract	contract
contractor	contract
contraction	contract
contracting	contract
contradiction	contradict
contrast	contrast
contravention	contravene
contributor	contribute
contribution	contribute
control	control
controller	control
controlling	control
convent	convene
convener	convene
convening	convene
convention	convene
convenience	convenience
conveniences	convenience
convert	convert
converter	convert
convertor	convert
conversion	convert
converting	convert
convertible	convert
convertibility	convert
conveyer	convey
conveyor	convey
conveying	convey
conveyance	convey
convict	convince
conviction	convince
convincing	convince
convincement	convince
convoy	convoy
cook	cook
cooker	cook
cookery	cook
cooking	cook
cool	cool
cooler	cool
coolant	cool
cooling	cool
coolness	cool
cooper	cooperate
cooperage	cooperate
cooperator	cooperate
cooperation	cooperate
cooperative	cooperate
cooperativeness	cooperate
coordinate	coordinate
coordinator	coordinate
coordination	coordinate
cope	cope
copal	cope
coping	cope
copper	copper
copy	copy
copier	copy
copying	copy
copyist	copy
copyright	copyright
core	core
coral	core
corn	corn
corner	corner
correcting	correct
correction	correct
corrective	correct
correctness	correct
correctitude	correct
correspondent	correspond
correspondence	correspond
corruption	corrupt
corruptness	corrupt
corruptibility	corrupt
cost	cost
costs	cost
costing	cost
cotton	cotton
counsel	counsel
counselor	counsel
counseling	counsel
count	count	counter
counter	count	counter
counting	count	counter
counterman	count	counter
countenance	countenance
counteraction	counteract
counterattack	counterattack
counterbalance	counterbalance
counterclaim	counterclaim
counterfeit	counterfeit
counterfeiter	counterfeit
counterpoint	counterpoint
country	country
coup	coup
coupe	coup
couple	couple
coupler	couple
coupling	couple
course	course
courser	course
coursing	course
court	court
courting	court
courtship	court
cover	cover
covering	cover
cow	cow
cows	cow
cowman	cow
crack	crack
cracker	crack
cracking	crack
craft	craft
crafter	craft
crane	crane
crash	crash
crasher	crash
crawl	crawl
crawler	crawl
crawling	crawl
creator	create
creation	create
creationism	create
credit	credit
creditor	credit
crediting	credit
crepe	crepe
crew	crew
crewman	crew
critic	criticize
critique	criticize
criticism	criticize
criticality	criticize
criticalness	criticize
crop	crop
cross	cross
crosse	cross
crossing	cross
crossness	cross
crowd	crowd
crowding	crowd
crown	crown
cruise	cruise
cruiser	cruise
crunch	crunch
crush	crush
crusher	crush
crushing	crush
cultivator	cultivate
cultivation	cultivate
culture	culture
curb	curb
curbing	curb
cure	cure
curtailment	curtail
curve	curve
curvature	curve
cushion	cushion
cushioning	cushion
cut	cut
cutting	cut
cycle	cycle
cycling	cycle
cyclist	cycle
cyclicity	cycle
dam	dam
damage	damage
damages	damage
damp	damp
damper	damp
dampness	damp
dampening	dampen
dart	dart
darts	dart
darter	dart
date	date
dawn	dawn
dawning	dawn
deaf	deaf
deafness	deaf
deal	deal
dealer	deal
dealing	deal
dealings	deal
debate	debate
debater	debate
debit	debit
debut	debut
decay	decay
deceleration	decelerate
december	december
deciding	decide
decision	decide
decisiveness	decide
deck	deck
decking	deck
declarator	declare
declaration	declare
declarative	declare
decline	decline
declination	decline
decontrol	decontrol
decrease	decrease
decree	decree
decrement	decree
decry	decry
decrial	decry
dedication	dedicate
deduction	deduce
deductible	deduce
deepening	deepen
default	default
defaulter	default
defeat	defeat
defeated	defeat
defeature	defeat
defeatism	defeat
defeatist	defeat
defeasance	defeat
defense	defend
defender	defend
defendant	defend
defensive	defend
defensibility	defend
deference	defer
deferment	defer
defining	define
definition	define
definiteness	define
deflector	deflect
deflection	deflect
defraudment	defraud
defraudation	defraud
defusing	defuse
degenerate	degenerate
degeneration	degenerate
degrade	degrade
degradation	degrade
delay	delay
delegate	delegate
delegating	delegate
delegation	delegate
deliberation	deliberate
deliberateness	deliberate
deliver	deliver
delivery	deliver
deliverer	deliver
deliverance	deliver
demand	demand
demander	demand
demise	demise
demonstrator	demonstrate
demonstration	demonstrate
demonstrative	demonstrate
demonstrability	demonstrate
demonstrativeness	demonstrate
denouncement	denounce
denunciation	denounce
dent	dent
dentist	dent
denial	deny
denier	deny
departed	depart
departer	depart
departure	depart
department	depart
dependant	depend
dependent	depend
dependance	depend
dependence	depend
dependency	depend
dependability	depend
dependableness	depend
depicting	depict
depiction	depict
depletion	deplete
deployment	deploy
depose	deposit
deposal	deposit
deposit	deposit
depositor	deposit
deposition	deposit
depreciator	depreciate
depreciation	depreciate
depress	depress
depressor	depress
depressant	depress
depression	depress
depressive	depress
deprivation	deprive
derailment	derail
deregulating	deregulate
deregulation	deregulate
derivate	derive
deriving	derive
derivation	derive
derivative	derive
description	describe
desert	desert
deserter	desert
desertion	desert
design	design	designate
designer	design	designate
designate	design	designate
designing	design	designate
designation	design	designate
desire	desire
desirability	desire
desirableness	desire
despatch	despatch
destroyer	destroy	destruct
destruction	destroy	destruct
destructibility	destroy	destruct
destructiveness	destroy	destruct
detail	detail
details	detail
detailing	detail
detector	detect
detecting	detect
detection	detect
detective	detect
determent	deter
deterrent	deter
deterrence	deter
deterioration	deteriorate
determiner	determine
determinant	determine
determinism	determine
determinist	determine
determination	determine
determinative	determine
determinateness	determine
detraction	detract
devaluation	devalue
developer	develop
developing	develop
development	develop
divest	divest
divesture	divest
divestment	divest
divestiture	divest
deviant	deviate
deviate	deviate
deviance	deviate
deviancy	deviate
deviation	deviate
device	devise
devise	devise
devisal	devise
devices	devise
devisee	devise
deviser	devise
devising	devise
devotion	devote
devotement	devote
dialogue	dialogue
dictate	dictate
dication	dictate
dictator	dictate
dictation	dictate
diet	diet
dietary	diet
dieting	diet
dietetics	diet
difference	differ
differential	differ
differentiator	differ
differentiation	differ
dig	dig
digs	dig
digging	dig
diggings	dig
digest	digest
digester	digest
digestion	digest
digestibility	digest
digestibleness	digest
dilute	dilute
dilutant	dilute
diluting	dilute
dilution	dilute
dimer	dim
dimness	dim
diminution	diminish
diminutive	diminish
diminishment	diminish
diminutiveness	diminish
dip	dip
director	direct
direction	direct
directive	direct
directness	direct
directivity	direct
directorate	direct
dirtying	dirty
dirtiness	dirty
disadvantage	disadvantage
disagreement	disagree
disagreeableness	disagree
disallowance	disallow
disappearing	disappear
disappearance	disappear
disarray	disarray
discard	discard
discarding	discard
discharge	discharge
discipline	discipline
disclosure	disclose
discontinuity	discontinue
discontinuance	discontinue
discontinuation	discontinue
discord	discord
discordant	discord
discordance	discord
discount	discount
discourage	discourage
discouragement	discourage
discover	discover
discovery	discover
discoverer	discover
discredit	discredit
discussant	discuss
discussion	discuss
disdain	disdain
disdainment	disdain
disdainfulness	disdain
disgorgement	disgorge
disguise	disguise
disk	disk
dislike	dislike
dismantle	dismantle
dismantling	dismantle
dismantlement	dismantle
dismay	dismay
dismember	dismember
dismemberment	dismember
dismiss	dismiss
dismissal	dismiss
dismission	dismiss
dispenser	dispense
dispensing	dispense
dispensation	dispense
dispensability	dispense
dispensableness	dispense
displacement	displace
display	display
dispose	dispose
disposal	dispose
disposure	dispose
disposition	dispose
dispute	dispute
disputant	dispute
disputation	dispute
disquiet	disquiet
disregard	disregard
disruption	disrupt
dissent	dissent
dissenter	dissent
dissident	dissent
dissension	dissent
dissidence	dissent
dissuasion	dissuade
distance	distance
distinction	distinguish
distinctness	distinguish
distinctiveness	distinguish
distort	distort
distortion	distort
distract	distract
distraction	distract
distress	distress
distressfulness	distress
distribute	distribute
distributer	distribute
distributor	distribute
distribution	distribute
district	district
distrust	distrust
distrustfulness	distrust
ditch	ditch
dive	dive
diver	dive
diving	dive
diversification	diversify
diverse	divert	diverse
diversion	divert	diverse
diversity	divert	diverse
diverseness	divert	diverse
divide	divide
divider	divide
dividers	divide
division	divide
divisibility	divide
divulsion	divulge
divulgence	divulge
divulgation	divulge
divulgement	divulge
do	do	don
don	do	don
dos	do	don
doer	do	don
door	do	don
doing	do	don
donee	do	don
dock	dock
docker	dock
dockage	dock
docking	dock
document	document
documentation	document
dodge	dodge
dodger	dodge
dodging	dodge
dog	dog
doll	doll
domine	dominate
dominant	dominate
dominance	dominate
domination	dominate
donation	donate
dong	dong
dot	dot
double	double
doubles	double
doubling	double
doubt	doubt
doubter	doubt
doubtfulness	doubt
down	down
downer	down
downgrade	downgrade
downsizing	downsize
draft	draft
draftee	draft
drafter	draft
drafting	draft
drag	drag
dragee	drag
drain	drain
drainage	drain
dramatisation	dramatise
draught	draught
draughts	draught
draw	draw
drawee	draw
drawer	draw
drawers	draw
drawing	draw
dream	dream
dreamer	dream
dreaming	dream
dredge	dredge
dredger	dredge
dribble	dribble
dribbler	dribble
dribbling	dribble
drift	drift
drifter	drift
drifting	drift
drill	drill
drilling	drill
drink	drink
drunk	drink
drinker	drink
drinking	drink
drunkenness	drink
drive	drive
driver	drive
driving	drive
drop	drop
dropping	drop
droppings	drop
drug	drug
drugging	drug
dry	dry
drier	dry
dryer	dry
dryness	dry
duck	duck
ducking	duck
dullness	dull
dump	dump
dumps	dump
dumper	dump
dumping	dump
duplicate	duplicate
duplicity	duplicate
duplicator	duplicate
duplicating	duplicate
duplication	duplicate
duplicability	duplicate
dust	dust
duster	dust
dustman	dust
dwindling	dwindle
dy	die
die	die
death	die
dying	die
dyke	dyke
dynamite	dynamite
dynamiter	dynamite
dynamitist	dynamite
earmark	earmark
earner	earn
earning	earn
earnings	earn
earth	earth
earthing	earth
earthman	earth
ease	ease
easing	ease
easement	ease
eats	eat
eater	eat
eating	eat
edible	eat
edibility	eat
edibleness	eat
ebb	ebb
edge	edge
edger	edge
edging	edge
edginess	edge
educatee	educate
eduction	educate
educator	educate
education	educate
effect	effect
effects	effect
effector	effect
effectivity	effect
effectiveness	effect
egg	egg
eggs	egg
elaboration	elaborate
elaborateness	elaborate
elect	elect
elector	elect
election	elect
electress	elect
electorate	elect
elimination	eliminate
embargo	embargo
embarkment	embark
embarkation	embark
emersion	emerge
emergence	emerge
emergency	emerge
emphasis	emphasize
emphasizing	emphasize
employ	employ
employee	employ
employer	employ
employment	employ
empty	empty
emptying	empty
emptiness	empty
emulsion	emulsion
enablement	enable
enactment	enact
encompassment	encompass
encounter	encounter
encouragement	encourage
encroacher	encroach
encroachment	encroach
end	end
ending	end
endangerment	endanger
endeavour	endeavour
endorser	endorse
endorsement	endorse
enforcer	enforce
enforcement	enforce
engagement	engage
engenderment	engender
engine	engineer
engineer	engineer
engineering	engineer
enhancement	enhance
enjoining	enjoin
enjoinment	enjoin
enjoyer	enjoy
enjoyment	enjoy
enjoyableness	enjoy
enquiry	enquire
enquirer	enquire
enrichment	enrich
enrolment	enroll
enrollment	enroll
entail	entail
entailment	entail
entry	enter	entrance
entrant	enter	entrance
ingress	enter	entrance
entrance	enter	entrance
enterics	enter	entrance
entering	enter	entrance
enteritis	enter	entrance
ingression	enter	entrance
entrancement	enter	entrance
entertainer	entertain
entertainment	entertain
enticement	entice
entitlement	entitle
envisagement	envisage
envisioning	envision
envy	envy
epoxy	epoxy
equal	equal
equality	equal
equaliser	equal
equalizer	equal
equalisation	equal
equalization	equal
equipment	equip
equipping	equip
eradicator	eradicate
eradication	eradicate
eraser	erase
erasure	erase
erecting	erect
erection	erect
erectness	erect
eroding	erode
erosion	erode
error	err
erratum	err
eruption	erupt
escalator	escalate
escalation	escalate
escape	escape
escapee	escape
escapade	escape
escapism	escape
escapist	escape
escapement	escape
eschewal	eschew
escort	escort
establishment	establish
estimate	estimate
estimator	estimate
estimation	estimate
evaluator	evaluate
evaluation	evaluate
evening	even
evenness	even
evidence	evidence
evolution	evolve
evolvement	evolve
exacerbation	exacerbate
exact	exact
exaction	exact
exactness	exact
exactitude	exact
examine	examine
examinee	examine
examiner	examine
examination	examine
example	example
excess	exceed
excessiveness	exceed
exception	except
exchange	exchange
exchanger	exchange
exchangeability	exchange
excise	excise
excision	excise
exciseman	excise
exclusion	exclude
exclusive	exclude
exclusiveness	exclude
excuse	excuse
executor	execute
executant	execute
execution	execute
executing	execute
executive	execute
executioner	execute
exemption	exempt
exercise	exercise
exerciser	exercise
exercising	exercise
exercitation	exercise
exertion	exert
exhaust	exhaust
exhaustion	exhaust
exhibit	exhibit
exhibitor	exhibit
exhibition	exhibit
exile	exile
existence	exist	existing
existentialism	exist	existing
exit	exit
expanse	expand
expansion	expand
expansivity	expand
expansiveness	expand
expatriate	expatriate
expatriation	expatriate
expectancy	expect
expectation	expect
expedient	expedite	expedient
expediency	expedite	expedient
expedience	expedite	expedient
expedition	expedite	expedient
expeditiousness	expedite	expedient
experience	experience
experiment	experience
experimenter	experience
experimentalism	experience
experimentation	experience
expiry	expire
expiration	expire
explain	explain
explanation	explain
exploit	exploit
exploiter	exploit
exploitation	exploit
explorer	explore
exploration	explore
export	export
exporter	export
exporting	export
exportation	export
expose	expose
exposure	expose
exposition	expose
express	express
expression	express
expressiveness	express
extension	extend
extensibility	extend
extent	extent
extract	extract
extractor	extract
extraction	extract
extrapolation	extrapolate
extrication	extricate
eye	eye
eyes	eye
eyeful	eye
face	face
facer	face
facing	face
faction	face
facilitator	facilitate
facilitation	facilitate
facsimile	facsimile
factor	factor
factoring	factor
factorisation	factor
factorization	factor
fade	fade
fading	fade
failing	fail
failure	fail
fair	fair
fairness	fair
fall	fall
falls	fall
fallal	fall
falling	fall
falter	falter
faltering	falter
fan	fan
fanion	fan
fare	fare
farness	fare
farm	farm
farmer	farm
farming	farm
fashion	fashion
fashions	fashion
fashioning	fashion
fast	fast
fasting	fast
fastness	fast
fat	fat
fatness	fat
fate	fate
fates	fate
father	father
fault	fault
favor	favor
favorableness	favor
favour	favour
favourite	favour
favouritism	favour
favourableness	favour
fear	fear
fearfulness	fear
feature	feature
fee	fee
feed	feed
feeder	feed
feeding	feed
feel	feel
feeler	feel
feeling	feel
feelings	feel
fell	fell
fellation	fell
felt	felt
fence	fence
fencer	fence
fencing	fence
fender	fend
ferry	ferry
ferris	ferry
ferrying	ferry
ferryman	ferry
fetch	fetch
fever	fever
field	field
fielder	field
fielding	field
fight	fight
fighter	fight
fighting	fight
figure	figure
figurer	figure
figuring	figure
figuration	figure
file	file
filer	file
filing	file
filibuster	filibuster
filibusterer	filibuster
fill	fill
fille	fill
filler	fill
filling	fill
fillip	fillip
film	film
filming	film
filmmaker	film
filmmaking	film
filter	filter
filtrate	filter
filtration	filter
finance	finance	financier
finances	finance	financier
financier	finance	financier
financing	finance	financier
find	find
finder	find
finding	find
fine	fine	finalize
final	fine	finalize
finale	fine	finalize
fining	fine	finalize
finality	fine	finalize
finalist	fine	finalize
fineness	fine	finalize
finalization	fine	finalize
finger	finger
fingering	finger
finish	finish
finisher	finish
finishing	finish
fire	fire
first	fire
firing	fire
fireman	fire
fieriness	fire
firm	firm
firmness	firm
fish	fish
fisher	fish
fishery	fish
fishing	fish
fit	fit
fitment	fit
fitness	fit
fitting	fit
fitfulness	fit
fix	fix
fixer	fix
fixing	fix
fixings	fix
fixture	fix
fixation	fix
fixative	fix
fizz	fizz
flag	flag
flagship	flag
flank	flank
flare	flare
flavor	flavor	flavour
flavour	flavor	flavour
flavorer	flavor	flavour
flavoring	flavor	flavour
flavourer	flavor	flavour
flavouring	flavor	flavour
fleet	fleet
fleetness	fleet
flesh	flesh
flex	flex
flexor	flex
flexion	flex
flection	flex
flip	flip
float	float
floater	float
flotation	float
floatation	float
flood	flood
flooding	flood
floor	floor
flooring	floor
flop	flop
flopping	flop
flour	flour
flourish	flourish
flow	flow
flowing	flow
fluctuation	fluctuate
flurry	flurry
flush	flush
fly	fly	flee	flight
flier	fly	flee	flight
flyer	fly	flee	flight
flight	fly	flee	flight
flying	fly	flee	flight
foam	foam
fob	fob
focus	focus
fodder	fodder
fog	fog
fold	fold
folder	fold
folding	fold
follower	follow
followers	follow
following	follow
foot	foot
footer	foot
footing	foot
footman	foot
foray	foray
forbidding	forbid
forbiddance	forbid
force	force
forcefulness	force
forecast	forecast
forecaster	forecast
forecasting	forecast
foresaw	foresaw
foresight	foresee
foresightfulness	foresee
foreshadowing	foreshadow
forest	forest
forester	forest
forestry	forest
forestalling	forestall
forestalment	forestall
forestallment	forestall
forfeit	forfeit
forfeiture	forfeit
forgetfulness	forget
fork	fork
forkful	fork
forking	fork
form	form	format
format	form	format
former	form	format
formation	form	format
formative	form	format
formatting	form	format
formal	formalise	formalize
formalism	formalise	formalize
formality	formalise	formalize
formalness	formalise	formalize
formalities	formalise	formalize
formalisation	formalise	formalize
formalization	formalise	formalize
formulation	formulate
formulization	formulate
fort	fort
forte	fort
forward	forward
forwarding	forward
forwardness	forward
fosterage	foster
fostering	foster
found	found	founder
founder	found	founder
founding	found	founder
foundation	found	founder
foundering	found	founder
fraction	fraction
fractionation	fraction
fractionisation	fraction
fractionization	fraction
frame	frame	frames
framer	frame	frames
framing	frame	frames
franchise	franchise
franchisement	franchise
frank	frank
frankness	frank
free	free
freedom	free
freeing	free
freeman	free
freight	freight
freighter	freight
frenzy	frenzy
frequence	frequent
frequency	frequent
frequenter	frequent
frequentation	frequent
fringe	fringe
front	front
frontal	front
frontage	front
frost	frost	freeze	freezing
freeze	frost	freeze	freezing
freezer	frost	freeze	freezing
freezing	frost	freeze	freezing
frosting	frost	freeze	freezing
fruit	fruit
fruition	fruit
fruitfulness	fruit
fuel	fuel
fueling	fuel
fulfilment	fulfil	fulfill
fulfillment	fulfil	fulfill
fulness	full
fullness	full
function	function
functionary	function
functioning	function
functionalism	function
fund	fund
funds	fund
funding	fund
funnel	funnel
fur	fur
furor	fur
furore	fur
furring	fur
furnishing	furnish
furnishings	furnish
furtherance	further
ga	gas
gas	gas
gasman	gas
gasification	gas
gain	gain
gainer	gain
gamble	gamble
gambler	gamble
gambling	gamble
game	game
gaming	game
gameness	game
gaminess	game
gander	gander
gap	gap
garage	garage
garden	garden
gardener	garden
gardening	garden
garment	garment
gate	gate
gather	gather
gatherer	gather
gathering	gather
gauge	gauge
gazette	gazette
gazetteer	gazette
gear	gear
gears	gear
gearing	gear
general	general	generalize
generality	general	generalize
generalist	general	generalize
generalization	general	generalize
generator	generate
generation	generate
gesture	gesture
getting	get
gift	give
give	give
given	give
giver	give
giving	give
givenness	give
gin	gin
glass	glass
glasses	glass
glassful	glass
glimpse	glimpse
glory	glory
glorification	glory
glut	glut
go	go
goal	go
goer	go
going	go
gold	gold	golden
gold-mining	gold	golden
golf	golf
golfer	golf
golfing	golf
goose	goose
gosling	goose
governed	govern
governor	govern
governess	govern
governing	govern
governance	govern
government	govern
grab	grab
grace	grace
graces	grace
gracefulness	grace
grade	grade
grader	grade
grading	grade
gradation	grade
grain	grain
graining	grain
granularity	grain
grant	grant
grantee	grant
grantor	grant
grave	grave
graveness	grave
gravel	gravel
gray	gray
grayness	gray
grease	grease
greaser	grease
greasiness	grease
green	green
greens	green
greenery	green
greening	green
greenness	green
greeting	greet
grey	grey
greyness	grey
grind	grind
grinder	grind
grinding	grind
grip	grip
gripe	grip
grit	grit
grits	grit
groove	groove
groover	groove
grooving	groove
gross	gross
grossness	gross
ground	ground
grounds	ground
grounder	ground
grounding	ground
group	group
grouper	group
grouping	group
grower	grow
growth	grow
growing	grow
guarantee	guarantee
guard	guard
guarding	guard
guess	guess
guessing	guess
gui	guy
guy	guy
guide	guide
guiding	guide
guidance	guide
gum	gum
gumming	gum
gun	gun
gunnery	gun
gut	gut
guts	gut
hail	hail
halt	halt
halter	halt
haltere	halt
ham	ham
hamming	ham
hammer	hammer
hammering	hammer
hamper	hamper
hand	hand
hands	hand
handful	hand
handle	handle
handler	handle
handling	handle
hang	hang	hanging
hanger	hang	hanging
hanging	hang	hanging
hangman	hang	hanging
hangar	hangar
happening	happen
harbor	harbor
harbour	harbour
harm	harm
harmfulness	harm
harvest	harvest
harvester	harvest
harvesting	harvest
harvestman	harvest
haste	hasten
hastings	hasten
hastening	hasten
hastiness	hasten
hate	hate
hater	hate
hatefulness	hate
haul	haul
hauler	haul
haulage	haul
hauling	haul
have	have
hay	hay
haying	hay
head	head
header	head
heading	head
headman	head
headful	head
headship	head
headline	headline
headliner	headline
headquarters	headquarter
heap	heap
heaps	heap
hearer	hear
hearing	hear
heat	heat
heater	heat
heating	heat
hector	hector
hedge	hedge
hedging	hedge
heed	heed
heedfulness	heed
helicopter	helicopter
help	help
helper	help
helping	help
helpfulness	help
herald	herald
herd	herd
herder	herd
hesitance	hesitate
hesitancy	hesitate
hesitater	hesitate
hesitator	hesitate
hesitation	hesitate
hiccup	hiccup
highlight	highlight
highlighting	highlight
hike	hike
hiker	hike
hindrance	hinder
hinge	hinge
hint	hint
hire	hire
hirer	hire
hiring	hire
hit	hit
hitting	hit
hoax	hoax
hoaxer	hoax
hog	hog
hold	hold
holder	hold
holding	hold
hole	hole
holiday	holiday
home	home
homer	home
hone	honor
honor	honor
honoring	honor
honorific	honor
honorableness	honor
honey	honey
honeycomb	honeycomb
honeymoon	honeymoon
honeymooner	honeymoon
honour	honour
honours	honour
honourableness	honour
hoof	hoof
hoofing	hoof
hook	hook
hooker	hook
hope	hope
hopeful	hope
hopefulness	hope
horse	horse
host	host
house	house
housing	house
houseful	house
houseman	house
housings	house
hover	hover
hulk	hulk
hull	hull
hunch	hunch
hunger	hunger
hungriness	hunger
hurdle	hurdle
hurdler	hurdle
hurdles	hurdle
hurdling	hurdle
hurry	hurry
hurrying	hurry
hurt	hurt
hurting	hurt
ice	ice
icing	ice
iceman	ice
iciness	ice
identification	identify
idler	idle
idling	idle
idleness	idle
igniter	ignite
ignitor	ignite
ignition	ignite
ignorant	ignore
ignorance	ignore
ignorantness	ignore
image	image	imagine
imagery	image	imagine
imagism	image	imagine
imaging	image	imagine
imagination	image	imagine
imaginativeness	image	imagine
immediacy	immediate
immediateness	immediate
impact	impact
impaction	impact
impair	impair
impairment	impair
impedance	impede
impedence	impede
impediment	impede
imperil	imperil
imperilment	imperil
implant	implant
implantation	implant
implement	implement
implementation	implement
implicant	imply	implicate
implicating	imply	implicate
implication	imply	implicate
import	import
importer	import
importing	import
importance	import
importation	import
impose	impose
imposition	impose
impoverishment	impoverish
impovempoverishment	impoverish
impress	impress
impression	impress
impressure	impress
impressment	impress
impressionism	impress
impressiveness	impress
improver	improve
improvement	improve
inch	inch
inclusion	include
income	income
incoming	income
incorporation	incorporate
incorporeality	incorporate
increase	increase
incur	incur
incurable	incur
incurment	incur
incurring	incur
incursion	incur
incurrence	incur
incurability	incur
incurableness	incur
indeed	indeed
indemnification	indemnify
indent	indenture
indenture	indenture
indentation	indenture
index	index
indexer	index
indexing	index
indexation	index
indic	indicate
indicant	indicate
indicator	indicate
indicating	indicate
indication	indicate
indicative	indicate
induct	induce
inductor	induce
inducing	induce
induction	induce
inducement	induce
inductance	induce
indulging	indulge
indulgence	indulge
infant	infancy
infancy	infancy
infantilism	infancy
infection	infect
inflater	inflate
inflator	inflate
inflation	inflate
infliction	inflict
inflow	inflow
influence	influence
inform	inform
informer	inform
informant	inform
informing	inform
informality	inform
information	inform
infringe	infringe
infringement	infringe
infuse	infuse
infusion	infuse
inheritor	inherit
inheritance	inherit
initial	initial	initiate
initiate	initial	initiate
initiator	initial	initiate
initiation	initial	initiate
initiative	initial	initiate
initialisation	initial	initiate
initialization	initial	initiate
injectant	inject
injection	inject
injury	injure
injuriousness	injure
ink	ink
inland	inland
input	input
insert	insert
insertion	insert
inside	inside
insider	inside
insisting	insist
insistence	insist
insistency	insist
inspire	inspire
inspiration	inspire
install	install
installing	install
instalment	install
installment	install
installation	install
instance	instance
instancy	instance
instantiation	instance
instill	instil	instill
instilling	instil	instill
instilment	instil	instill
instillator	instil	instill
instillment	instil	instill
instillation	instil	instill
institute	institute
institution	institute
instrument	instrument
instrumental	instrument
instrumentality	instrument
instrumentation	instrument
insulant	insulate
insulator	insulate
insulation	insulate
insult	insult
insurer	insure
insurance	insure
integral	integrate
integrity	integrate
integrator	integrate
integration	integrate
integrating	integrate
intent	intend	intent
intention	intend	intent
intentness	intend	intent
intense	intense
intension	intense
intensity	intense
intensive	intense
intensiveness	intense
intensifier	intensify
intensification	intensify
intensificatiion	intensify
interment	inter
interconnection	interconnect
interest	interest
interference	interfere
intermediate	intermediate
intermediator	intermediate
intermediation	intermediate
international	international	internationalise
internationality	international	internationalise
internationalism	international	internationalise
internationalist	international	internationalise
internationalisation	international	internationalise
internationalization	international	internationalise
interpreter	interpret
interpreting	interpret
interpretation	interpret
interrupter	interrupt
interruption	interrupt
intervention	intervene
interview	interview
interviewee	interview
interviewer	interview
introduction	introduce
invalid	invalid	invalidate
invalidism	invalid	invalidate
invalidity	invalid	invalidate
invalidness	invalid	invalidate
invalidation	invalid	invalidate
inventory	inventory
inventorying	inventory
invest	invest
investor	invest
investing	invest
investment	invest
investigator	investigate
investigating	investigate
investigation	investigate
invite	invite
invitee	invite
invitation	invite
invoice	invoice
invocation	invoke
involvement	involve
inward	inward
inwardness	inward
iron	iron
irons	iron
irony	iron
ironing	iron
ironist	iron
irrigation	irrigate
isolation	isolate
issue	issue
issus	issue
issuer	issue
issuant	issue
issuing	issue
issuance	issue
jack	jack
jacks	jack
jacket	jacket
jail	jail
jailer	jail
jailing	jail
jam	jam
jamming	jam
japan	japan
jar	jar
jarful	jar
jargon	jargon
jargonisation	jargon
jargonization	jargon
jaw	jaw
jaws	jaw
jeep	jeep
jeopardy	jeopardize
jet	jet
jets	jet
job	job
join	join
joiner	join
joinder	join
joining	join
jointure	join
junction	join
joint	joint
jointer	joint
journey	journey
journeyer	journey
journeying	journey
journeyman	journey
joy	joy
judge	judge
judges	judge
judging	judge
judgment	judge
judgship	judge
judgement	judge
judgeship	judge
juice	juice
juicer	juice
juiciness	juice
jump	jump
jumper	jump
jumpers	jump
jumping	jump
junk	junk
junker	junk
justifier	justify
justification	justify
keen	keen
keenness	keen
keep	keep
keeper	keep
keeping	keep
key	key
kill	kill
killer	kill
killing	kill
knight	knight
knit	knit
knitting	knit
knock	knock
knocker	knock
knocking	knock
knowing	know
knowledge	know
knuckle	knuckle
knuckles	knuckle
label	label
labor	labor
laborer	labor
laboriousness	labor
labour	labour
labourer	labour
labourite	labour
lack	lack
ladder	ladder
lading	laden
lag	lag
lager	lag
lagging	lag
lamb	lamb
lame	lame
lameness	lame
laminate	laminate
laminitis	laminate
lamination	laminate
land	land
landing	land
landman	land
landscape	landscape
landscaping	landscape
landscapist	landscape
lap	lap
lapful	lap
lapping	lap
lapse	lapse
lapsing	lapse
lard	lard
larder	lard
last	last
launch	launch
launcher	launch
launching	launch
lay	lay	layer
layer	lay	layer
laying	lay	layer
layman	lay	layer
leach	leach
leaching	leach
lead	lead
leader	lead
leaders	lead
leading	lead
leaf	leaf
leafing	leaf
league	league
leak	leak
leakage	leak
lean	lean
leaning	lean
leanness	lean
leap	leap
leaping	leap
learner	learn
learning	learn
lease	lease
lessee	lease
lessor	lease
leather	leather
leave	leave
leaver	leave
leaving	leave
lecture	lecture
lecturer	lecture
lecturing	lecture
lectureship	lecture
leg	leg
leger	leg
legacy	leg
legate	leg
legion	leg
legging	leg
legation	leg
legerity	leg
legislator	legislate
legislation	legislate
legislature	legislate
legislating	legislate
legitimacy	legitimate
legitimation	legitimate
legitimization	legitimate
lender	lend
lending	lend
lessening	lessen
let	let
letting	let
letter	letter
letters	letter
lettering	letter
letterman	letter
level	level
leveler	level
leveling	level
leveller	level
lever	leverage
leverage	leverage
leveraging	leverage
levi	levy
levy	levy
levis	levy
li	lie
lie	lie
liar	lie
lied	lie
lying	lie
liberal	liberalise	liberalize
liberator	liberalise	liberalize
liberality	liberalise	liberalize
liberalism	liberalise	liberalize
liberation	liberalise	liberalize
liberalness	liberalise	liberalize
liberalisation	liberalise	liberalize
liberalization	liberalise	liberalize
licence	licence
license	license
licensee	license
lift	lift
lifter	lift
liftman	lift
light	light	lighter
lighter	light	lighter
lighting	light	lighter
lightness	light	lighter
lightship	light	lighter
enlightened	light	lighter
enlightenment	light	lighter
lightening	lighten
lightning	lightning
like	like
liking	like
likeness	like
likelihood	like
limit	limit
limiter	limit
limiting	limit
limitation	limit
line	line
liner	line
lining	line
lineman	line
lineation	line
link	link
links	link
linkage	link
linkman	link
lint	lint
lipstick	lipstick
liquid	liquidate
liquidity	liquidate
liquidator	liquidate
liquidizer	liquidate
liquidness	liquidate
liquidation	liquidate
liquefaction	liquidate
liquifaction	liquidate
liquidization	liquidate
list	list
lister	list
listing	list
listener	listen
listening	listen
life	live	enliven
liver	live	enliven
living	live	enliven
liveness	live	enliven
enlivenment	live	enliven
load	load
loads	load
loader	load
loading	load
loan	loan
loaner	loan
loathing	loath	loathe
loathsomeness	loath	loathe
lobby	lobby
lobbyist	lobby
locator	locate
locating	locate
location	locate
locative	locate
lock	lock
locke	lock
locker	lock
locking	lock
lockman	lock
lodge	lodge
lodger	lodge
lodging	lodge
lodgment	lodge
lodgings	lodge
lodgement	lodge
long	long
length	long
longing	long
longness	long
lengthening	long
look	look
looker	look
looking	look
loom	loom
looseness	loose
loosening	loosen
loot	loot
looter	loot
looting	loot
loss	lose
loser	lose
losses	lose
losings	lose
lot	lot
lots	lot
love	love
lover	love
lovely	love
low	low
lowness	low
lower	lower
lowering	lower
lull	lull
lumber	lumber
lumberman	lumber
lump	lump
lumper	lump
lunch	lunch
luncher	lunch
lunching	lunch
luncheon	luncheon
lure	lure
machine	machine
machinery	machine
machinist	machine
machinator	machine
machination	machine
mail	mail
mailer	mail
mailman	mail
mailing	mail
maintenance	maintain
major	major
majors	major
majority	major
make	make
maker	make
making	make
malt	malt
malted	malt
maltman	malt
man	man
manor	man
manfulness	man
manager	manage
managing	manage
management	manage
manageability	manage
manageableness	manage
mandate	mandate
manifest	manifest
manifestation	manifest
manipulator	manipulate
manipulation	manipulate
manipulability	manipulate
manoeuvre	manoeuvre
manufacture	manufacture
manufacturer	manufacture
manufacturing	manufacture
map	map
mapping	map
mar	mar
mars	mar
march	march
marche	march
marcher	march
marches	march
marching	march
mark	mark
marker	mark
marking	mark
market	market
marketing	market
martyr	martyr
martyrisation	martyr
martyrization	martyr
mass	mass
masse	mass
masses	mass
master	master
mastery	master
mastering	master
mastership	master
mastermind	mastermind
mat	mat
matt	mat
matte	mat
matman	mat
matting	mat
match	match
material	materialize
materialism	materialize
materialist	materialize
materiality	materialize
materialization	materialize
matter	matter
maturity	mature
maturing	mature
maturation	mature
maturement	mature
matureness	mature
maxim	maximise	maximize
maximation	maximise	maximize
maximisation	maximise	maximize
maximization	maximise	maximize
may	may
mayor	may
mean	mean
means	mean
meaning	mean
meanness	mean
measure	measure
measuring	measure
measurement	measure
measurability	measure
medicine	medicine
meet	meet
meeting	meet
melt	melt
meltage	melt
melting	melt
mention	mention
merchandise	merchandise
merchandiser	merchandise
merchandising	merchandise
merchandisement	merchandise
merger	merge
merging	merge
mergence	merge
merit	merit
meritoriousness	merit
metal	metal
metalization	metal
metallisation	metal
metallization	metal
meter	meter
microfilm	microfilm
microwave	microwave
middle	middle
middling	middle
middleman	middle
might	might
mildew	mildew
militant	militate
militance	militate
militancy	militate
militation	militate
milk	milk
milker	milk
milkman	milk
mill	mill
miller	mill
milling	mill
million	mill
millions	mill
mind	mind
minder	mind
mindfulness	mind
mine	mine
miner	mine
mining	mine
minion	mine
minor	mine
minim	minimise	minimize
minimisation	minimise	minimize
minimization	minimise	minimize
minister	minister
ministry	minister
ministrant	minister
ministration	minister
mint	mint
mintage	mint
minute	minute
minutes	minute
minuteman	minute
minuteness	minute
mirror	mirror
misconduct	misconduct
misconduction	misconduct
mismatch	mismatch
miss	miss
missal	miss
mission	miss
missioner	miss
missionary	miss
misstatement	misstate
mistake	mistake
mistaking	mistake
misuse	misuse
mitigation	mitigate
mix	mix
mixer	mix
mixing	mix
mixture	mix
model	model
modeler	model
modeling	model
modeller	model
modelling	model
moderacy	moderate
moderate	moderate
moderator	moderate
moderation	moderate
moderatism	moderate
moderateness	moderate
modern	modernise	modernize
modernist	modernise	modernize
modernism	modernise	modernize
modernity	modernise	modernize
modernness	modernise	modernize
modernizing	modernise	modernize
modernisation	modernise	modernize
modernization	modernise	modernize
modifier	modify
modification	modify
mollification	mollify
monitor	monitor
monitoring	monitor
moonshine	moonshine
moonshiner	moonshine
mop	mop
mopping	mop
mortgage	mortgage
mortgagee	mortgage
mortgagor	mortgage
mothball	mothball
motion	motion
motive	motive	motivate
motivity	motive	motivate
motivation	motive	motivate
motor	motor
motorist	motor
motoring	motor
motorman	motor
motorisation	motor
motorization	motor
mould	mould
moult	mould
moulding	mould
moulting	mould
mount	mount
mounting	mount
mouse	mouse
mousing	mouse
mouth	mouth
mouthful	mouth
move	move
mover	move
moving	move
movement	move
mud	mud	muddy
muddiness	mud	muddy
multiple	multiply
multiplier	multiply
multiplicity	multiply
multiplication	multiply
muscle	muscle
musculature	muscle
nail	nail
name	name
names	name
naming	name
nap	nap
narrow	narrow
narrowing	narrow
narrowness	narrow
nearness	near
necessity	necessitate
necessitation	necessitate
neck	neck
necking	neck
need	need
negative	negative
negativism	negative
negativist	negative
negativity	negative
negativeness	negative
negotiant	negotiate
negotiator	negotiate
negotiation	negotiate
negotiability	negotiate
neighbor	neighbor
neighbour	neighbour
net	net
netting	net
network	network
neutral	neutralize
neutralist	neutralize
neutralism	neutralize
neutrality	neutralize
neutralisation	neutralize
neutralization	neutralize
nickel	nickel
noise	noise
noisiness	noise
nominal	nominate
nomination	nominate
nominalism	nominate
nominating	nominate
nominative	nominate
normal	normalize
normality	normalize
normalisation	normalize
normalization	normalize
note	note
notion	note
notions	note
notation	note
notice	notice
noticeability	notice
noticeableness	notice
notifying	notify
notification	notify
nuance	nuance
nudge	nudge
number	number
numbers	number
numbering	number
nurse	nurse
nursing	nurse
object	object
objector	object
objection	object
objective	object
objectivity	object
objectiveness	object
objectionability	object
objectionableness	object
obligation	oblige	obligate
obscurity	obscure
obscuration	obscure
obscureness	obscure
observer	observe
observant	observe
observance	observe
observation	observe
observatory	observe
obtainment	obtain
occasion	occasion
occasions	occasion
occasionment	occasion
occupant	occupy
occupier	occupy
occupancy	occupy
occupying	occupy
occupation	occupy
occurence	occur
offing	of
offer	offer
offering	offer
office	officer
officer	officer
official	officer
officiating	officer
officiation	officer
officiousness	officer
offset	offset
oil	oil
oiler	oil
oilman	oil
okay	okay
omission	omit
omnibus	omnibus
opal	opt
option	opt
optative	opt
open	open
opener	open
opening	open
openness	open
operator	operate
operation	operate
operative	operate
operations	operate
operability	operate
opposite	oppose
opposition	oppose
oppositeness	oppose
optimum	optimize
optimism	optimize
optimisation	optimize
optimization	optimize
order	order
ordering	order
organisation	organise
orient	orient
oriental	orient
orientation	orient
orientalisation	orient
orientalization	orient
origin	originate
original	originate
originator	originate
originalism	originate
originality	originate
origination	originate
ouster	oust
ousting	oust
out	out
outing	out
outcry	outcry
outlay	outlay
outline	outline
output	output
outwardness	outward
overburden	overburden
overcast	overcast
overcasting	overcast
overhang	overhang
overhaul	overhaul
overhauling	overhaul
overhead	overhead
overlap	overlap
overlapping	overlap
overlook	overlook
overnighter	overnight
overseer	oversee
overshoot	overshoot
oversupply	oversupply
overtaking	overtake
overturn	overturn
overturning	overturn
owner	own
pace	pace
pacer	pace
pacing	pace
pack	pack	package
packer	pack	package
package	pack	package
packing	pack	package
packaging	pack	package
pad	pad
padding	pad
page	page
paging	page
pageant	page
pageantry	page
pagination	page
pain	pain
pains	pain
painfulness	pain
paint	paint
painter	paint
painting	paint
pair	pair
pairing	pair
pall	pall
pallor	pall
palm	palm
palmer	palm
palmist	palm
panel	panel
paneling	panel
panelist	panel
panelling	panel
panhandle	panhandle
panhandler	panhandle
panic	panic
paper	paper
papers	paper
paperer	paper
papering	paper
par	par
paragraph	paragraph
paragrapher	paragraph
parallel	parallel
parallelism	parallel
paralysis	paralyse
paralysation	paralyse
paralyzation	paralyse
parcel	parcel
parceling	parcel
parcelling	parcel
parer	pare	parent
parent	pare	parent
paring	pare	parent
parings	pare	parent
parentage	pare	parent
park	park
parking	park
part	part
parts	part
parting	part
partition	part
partitive	part
partitionist	part
partitioning	part
party	party
participant	participate
participance	participate
participation	participate
partner	partner
partnership	partner
pass	pass
passer	pass
passion	pass
passing	pass
passeres	pass
passionateness	pass
past	paste
paste	paste
pasty	paste
pastis	paste
pastor	paste
pasties	paste
pastness	paste
pastoral	paste
pastorate	paste
pasture	pasture
pat	pat
pater	pat
patness	pat
patch	patch
patching	patch
patent	patent
patentee	patent
patrol	patrol
patroller	patrol
patrolman	patrol
patrolling	patrol
patron	patronage
patronage	patronage
patronization	patronage
pattern	pattern
pause	pause
paving	pave
pavement	pave
pay	pay
payee	pay
payer	pay
paying	pay
payment	pay
peak	peak
peer	peer
peg	peg
pen	pen
penman	pen
penance	pen
penning	pen
penalisation	penalise	penalize
penalization	penalise	penalize
penetration	penetrate
penetrability	penetrate
pension	pension
pensioner	pension
people	people
pep	pep
pepper	pepper
percept	perceive
perceiver	perceive
perception	perceive
perceiving	perceive
perceptivity	perceive
perceptibility	perceive
perceptiveness	perceive
perfect	perfect
perfection	perfect
perfective	perfect
perfectability	perfect
perfectibility	perfect
performer	perform
performing	perform
performance	perform
perfume	perfume
perfumer	perfume
perfumery	perfume
peril	peril
perilousness	peril
permit	permit
permission	permit
permissibility	permit
permissiveness	permit
peroxide	peroxide
perpetuity	perpetuate
perpetuation	perpetuate
persistence	persist
persistency	persist
person	personalize
personal	personalize
personage	personalize
personation	personalize
personality	personalize
personableness	personalize
personalisation	personalize
personalization	personalize
persuader	persuade
persuasion	persuade
persuasiveness	persuade
pet	pet
petting	pet
petition	petition
petitioner	petition
phase	phase
phone	phone
phoner	phone
photo	photo
phrase	phrase
phrasing	phrase
pick	pick
picker	pick
picking	pick
picture	picture
picturing	picture
piece	piece
pig	pig
pigman	pig
piggery	pig
pigment	pig
pigmentation	pig
pile	pile
piles	pile
piling	pile
pilot	pilot
pilotage	pilot
piloting	pilot
pin	pin
pinning	pin
pinch	pinch
pinche	pinch
pinpoint	pinpoint
pipe	pipe
piper	pipe
pipes	pipe
piping	pipe
pipeful	pipe
pit	pit
pitman	pit
pitting	pit
pity	pity
place	place
placer	place
placeman	place
placement	place
plain	plain
plainness	plain
plan	plan
planning	plan
plane	plane
planer	plane
planation	plane
planeness	plane
plant	plant
planter	plant
planting	plant
plantation	plant
plate	plate
plating	plate
plateful	plate
play	play
player	play
playing	play
plea	plead
pleading	plead
pleasant	please	pleasure
pleasure	please	pleasure
pleasing	please	pleasure
pleasance	please	pleasure
pleasantry	please	pleasure
pleasantness	please	pleasure
pledge	pledge
plight	plight
plough	plough
ploughing	plough
ploughman	plough
plow	plow
plowing	plow
plug	plug
plummet	plummet
plunge	plunge
plunger	plunge
pocket	pocket
pocketful	pocket
pod	pod
point	point
pointer	point
pointing	point
poison	poison
poisoner	poison
poisoning	poison
police	police
policeman	police
poll	poll
polls	poll
pollard	pollard
pool	pool
port	port	portion	portend
portal	port	portion	portend
porter	port	portion	portend
portent	port	portion	portend
portion	port	portion	portend
pose	pose	position
poser	pose	position
posing	pose	position
position	pose	position
positive	pose	position
positioner	pose	position
positivity	pose	position
positioning	pose	position
positiveness	pose	position
post	post
poster	post
posting	post
postman	post
posterity	post
postponer	postpone
postponement	postpone
posture	posture
posturing	posture
pot	pot
potful	pot
potion	pot
potman	pot
pottery	pot
potation	pot
pound	pound
poundal	pound
pounder	pound
pounding	pound
pouring	pour
powder	powder
power	power
powerfulness	power
practice	practice	practise
practise	practice	practise
practicality	practice	practise
practicability	practice	practise
practicableness	practice	practise
praise	praise
prawn	prawn
precaution	precaution
precipitant	precipitate
precipitate	precipitate
precipitance	precipitate
precipitancy	precipitate
precipitator	precipitate
precipitation	precipitate
precipitateness	precipitate
precipitousness	precipitate
preclusion	preclude
predictor	predict
prediction	predict
predictability	predict
predominance	predominate
predomination	predominate
preemption	preempt
preference	prefer
preferment	prefer
preferability	prefer
prejudice	prejudice
prelude	prelude
prelusion	prelude
premier	premier	premiere
premiere	premier	premiere
premiership	premier	premiere
preparation	prepare
preparative	prepare
prepayment	prepay
present	present
presence	present
presenter	present
presentment	present
presentness	present
presentation	present
preserve	preserve
preserver	preserve
preserves	preserve
preserving	preserve
preservation	preserve
preservative	preserve
preside	preside
president	preside
presidency	preside
press	press	pressure	pressurise
pressure	press	pressure	pressurise
pressman	press	pressure	pressurise
pressing	press	pressure	pressurise
pressurisation	press	pressure	pressurise
pressurization	press	pressure	pressurise
presumption	presume
presumptuousness	presume
pretence	pretend
pretense	pretend
pretender	pretend
pretending	pretend
pretension	pretend
prevalence	prevail
prevent	prevent
prevention	prevent
preventive	prevent
preventative	prevent
preview	preview
prey	prey
preying	prey
predator	prey
predation	prey
price	price
pricing	price
pride	pride
pridefulness	pride
prime	prime
primer	prime
primacy	prime
priming	prime
primness	prime
print	print
printer	print
printing	print
privacy	privatize
private	privatize
privates	privatize
privateer	privatize
privation	privatize
privateness	privatize
probe	probe
probing	probe
process	proceed	process
proceeds	proceed	process
procedure	proceed	process
processor	proceed	process
proceeding	proceed	process
processing	proceed	process
procession	proceed	process
proceedings	proceed	process
processional	proceed	process
procure	procure
procural	procure
procurer	procure
procurance	procure
procurator	procure
procurement	procure
prod	prod
prodding	prod
produce	produce
product	produce
producer	produce
production	produce
productivity	produce
productiveness	produce
profile	profile
profit	profit
profits	profit
profiteer	profit
profiteering	profit
profitability	profit
profitableness	profit
profundity	profound
profoundness	profound
program	program
programming	program
programme	programme
programmer	programme
progress	progress
progression	progress
progressive	progress
progressivity	progress
progressiveness	progress
prohibition	prohibit
project	project
projector	project
projection	project
prolongment	prolong
prolongation	prolong
promise	promise
promisee	promise
promiser	promise
promisor	promise
promote	promote
promoter	promote
promotion	promote
prompt	prompt
prompter	prompt
prompting	prompt
promptness	prompt
proof	proof	prove
proving	proof	prove
provence	proof	prove
provencal	proof	prove
provenance	proof	prove
prop	prop
propman	prop
propeller	propel
propellant	propel
propellent	propel
propulsion	propel
proportion	proportion	proportionate
proportional	proportion	proportionate
proportionment	proportion	proportionate
proportionality	proportion	proportionate
proportionation	proportion	proportionate
proportionateness	proportion	proportionate
propose	propose
proposal	propose
proposer	propose
prospect	prospect
prospector	prospect
prosperity	prosper
prostate	prostate
prostatitis	prostate
protector	protect
protecting	protect
protection	protect
protectorate	protect
protectiveness	protect
provider	provide	provision
provision	provide	provision
providing	provide	provision
providence	provide	provision
provisions	provide	provision
provisioner	provide	provision
provoker	provoke
provocation	provoke
provocative	provoke
public	publish	publicise	publicize
publicist	publish	publicise	publicize
publicity	publish	publicise	publicize
publisher	publish	publicise	publicize
publicizer	publish	publicise	publicize
publishing	publish	publicise	publicize
publication	publish	publicise	publicize
publicizing	publish	publicise	publicize
publicization	publish	publicise	publicize
pull	pull
pullman	pull
pulling	pull
pulp	pulp
pump	pump
pumps	pump
punch	punch
puncher	punch
punt	punt
punter	punt
punting	punt
purchase	purchase
purchaser	purchase
purchasing	purchase
puree	puree
pureness	puree
purge	purge
purging	purge
purgation	purge
purgative	purge
purgatory	purge
purpose	purpose
purposefulness	purpose
purse	purse
purser	purse
pursued	pursue
pursuer	pursue
pursuit	pursue
pursuant	pursue
pursuance	pursue
push	push
pusher	push
pushing	push
put	put
putting	put
quake	quake
quaker	quake
quakers	quake
quakerism	quake
qualifier	qualify
qualifying	qualify
qualification	qualify
quantifier	quantify
quantification	quantify
quantifiability	quantify
quarantine	quarantine
quarrel	quarrel
quarrelsomeness	quarrel
quarter	quarter
quarters	quarter
quartering	quarter
quelling	quell
query	query
question	question
questioner	question
questioning	question
quibble	quibble
quibbler	quibble
quickening	quicken
quiet	quiet
quietism	quiet
quietist	quiet
quietness	quiet
quote	quote
quotation	quote
rack	rack
racket	racket
racketeer	racket
racketeering	racket
radio	radio
raid	raid
raider	raid
rail	rail
rails	rail
railing	rail
railroad	railroad
railroader	railroad
rain	rain
raise	raise
raiser	raise
raising	raise
rally	rally
rallying	rally
ramp	ramp
rampage	rampage
ranch	ranch
ranching	ranch
range	range
ranger	range
rank	rank
ranker	rank
ranking	rank
rankness	rank
ransom	ransom
rape	rape
raper	rape
rapist	rape
rate	rate
rating	rate
ratifier	ratify
ratification	ratify
ration	ration	rationalise	rationalize
rationing	ration	rationalise	rationalize
rationality	ration	rationalise	rationalize
rationalist	ration	rationalise	rationalize
rationalism	ration	rationalise	rationalize
rationalness	ration	rationalise	rationalize
rationalisation	ration	rationalise	rationalize
rationalization	ration	rationalise	rationalize
ray	ray
reach	reach
reaching	reach
react	react
reactor	react
reactant	react
reaction	react
reactance	react
reactionism	react
reactivity	reactivate
reactivation	reactivate
read	read
reader	read
reading	read
ready	ready
readying	ready
readiness	ready
realist	realise	realize
realisation	realise	realize
realization	realise	realize
reason	reason
reasoner	reason
reasoning	reason
reasonableness	reason
reassembly	reassemble
reassessment	reassess
reassurance	reassure
rebate	rebate
rebel	rebel
rebellion	rebel
rebound	rebound
rebuilding	rebuild
recall	recall
recapitalization	recapitalize
recapture	recapture
recess	recede
receding	recede
recession	recede
recessional	recede
receipt	receipt	receive
receipts	receipt	receive
receiver	receipt	receive
receptor	receipt	receive
reception	receipt	receive
recipient	receipt	receive
receiving	receipt	receive
receivables	receipt	receive
receptivity	receipt	receive
receptiveness	receipt	receive
reclamation	reclaim
recognition	recognise	recognize
recognisance	recognise	recognize
recognizance	recognise	recognize
recommendation	recommend
reconsideration	reconsider
record	record
recorder	record
recording	record
recordation	record
recoupment	recoup
recover	recover
recovery	recover
recoverer	recover
rectifier	rectify
rectification	rectify
recur	recur
recurse	recur
recursion	recur
recurrence	recur
recycling	recycle
redeemer	redeem
redemption	redeem
redeployment	redeploy
redirection	redirect
redouble	redouble
redress	redress
reducer	reduce
reducing	reduce
reduction	reduce
reevaluation	reevaluate
reexamination	reexamine
referent	refer	reference
referral	refer	reference
reference	refer	reference
refine	refine	refinance
refiner	refine	refinance
refinery	refine	refinance
refining	refine	refinance
refinement	refine	refinance
reflation	reflate
reflector	reflect
reflection	reflect
reflectance	reflect
reflectivity	reflect
reform	reform
reformer	reform
reformist	reform
reformation	reform
reformatory	reform
refrain	refrain
refrainment	refrain
refueling	refuel
refuge	refuge
refund	refund
refuse	refuse
refusal	refuse
refuting	refute
refutation	refute
regaining	regain
regard	regard
regards	regard
regeneration	regenerate
register	register
registry	register
registrar	register
registrant	register
registration	register
regret	regret
regrets	regret
regular	regularize
regularity	regularize
regularisation	regularize
regularization	regularize
regulator	regulate
regulation	regulate
regulating	regulate
rehabilitation	rehabilitate
reign	reign
reimbursement	reimburse
rein	rein
reins	rein
reinforcer	reinforce
reinforcement	reinforce
reinstatement	reinstate
reinvestment	reinvest
reiteration	reiterate
reject	reject
rejection	reject
relation	relate
relative	relate
relations	relate
relativity	relate
relaxant	relax
relaxation	relax
release	release
relief	relieve
reliever	relieve
relinquishing	relinquish
relinquishment	relinquish
relocation	relocate
reliant	rely
reliance	rely
remains	remain	remainder
remainder	remain	remainder
remanence	remain	remainder
remark	remark
remedy	remedy
remediation	remedy
remember	remember
remembering	remember
remembrance	remember
remind	remind
reminder	remind
remittal	remit
remission	remit
remittance	remit
remissness	remit
remittence	remit
remove	remove
removal	remove
remover	remove
rent	rent
rente	rent
rental	rent
renter	rent
renting	rent
render	render
rendering	render
rendition	render
renege	renege
renegotiation	renegotiate
renew	renew	renewal
renewal	renew	renewal
renouncement	renounce
renunciation	renounce
renovator	renovate
renovation	renovate
reorganization	reorganize
repair	repair
repairer	repair
repairman	repair
reparable	repair
reparation	repair
repatriate	repatriate
repatriation	repatriate
repayment	repay
repeal	repeal
repeat	repeat	repetition
repeater	repeat	repetition
repeating	repeat	repetition
repetition	repeat	repetition
repetitiveness	repeat	repetition
repetitiousness	repeat	repetition
replacing	replace
eplacement	replace
replacement	replace
replaceability	replace
replenishment	replenish
reply	reply
report	report
reporter	report
reportage	report
reporting	report
repositing	reposition
reposition	reposition
repositioning	reposition
represent	represent
representation	represent
representative	represent
reproducer	reproduce
reproduction	reproduce
reproducibility	reproduce
request	request
requisite	require
requirement	require
requisition	require
requisiteness	require
rescinding	rescind
rescission	rescind
rescindment	rescind
rescue	rescue
rescuer	rescue
research	research
researcher	research
resemblant	resemble
resemblance	resemble
reserve	reserve
reserves	reserve
reservist	reserve
reservation	reserve
reset	reset
resettlement	resettle
reshuffle	reshuffle
reshuffling	reshuffle
resign	resign
resignation	resign
resin	resin
resination	resin
resister	resist
resistor	resist
resistant	resist
resistance	resist
resistivity	resist
resolve	resolve
resolute	resolve
resolvent	resolve
resolving	resolve
resolution	resolve
resoluteness	resolve
resort	resort
respect	respect
respects	respect
respecter	respect
respectability	respect
respectfulness	respect
response	respond
responder	respond
respondent	respond
responsibility	respond
responsiveness	respond
responsibleness	respond
rest	rest
restfulness	rest
restatement	restate
restore	restore
restorer	restore
restoration	restore
restorative	restore
restrain	restrain
restraint	restrain
restriction	restrict
restrictiveness	restrict
result	result
resultant	result
resume	resume
resumption	resume
resurge	resurge
resurgence	resurge
resurrection	resurrect
retail	retail
retailer	retail
retailing	retail
retainer	retain
retention	retain
retentivity	retain
retentiveness	retain
retaliator	retaliate
retaliation	retaliate
rethink	rethink
retire	retire
retiree	retire
retirement	retire
retract	retract
retractor	retract
retraction	retract
retreat	retreat
retreated	retreat
retreatant	retreat
return	return
revaluation	revalue
revamping	revamp
revel	reveal
reveal	reveal
reveler	reveal
revelry	reveal
reveller	reveal
revelment	reveal
revealing	reveal
revelation	reveal
reverse	revert	reverse
reversal	revert	reverse
reversion	revert	reverse
reverting	revert	reverse
reversible	revert	reverse
reversibility	revert	reverse
review	review
reviewer	review
revise	revise
revisal	revise
reviser	revise
revising	revise
revision	revise
revitalisation	revitalise	revitalize
revitalization	revitalise	revitalize
revival	revive
revivalism	revive
revoke	revoke
revocable	revoke
revocation	revoke
revocability	revoke
revolt	revolt
revolver	revolt
revolution	revolt
revolutionary	revolt
reward	reward
rib	rib
ribbing	rib
riddance	rid
ride	ride
rider	ride
riding	ride
ridicule	ridicule
ridiculousness	ridicule
rig	rig
rigor	rig
rigging	rig
rigorousness	rig
right	right
rightist	right
rightness	right
rightfulness	right
ring	ring
rung	ring
ringer	ring
ringing	ring
rise	rise
riser	rise
rising	rise
risk	risk
risking	risk
rival	rival
rivalry	rival
roast	roast
roaster	roast
roasting	roast
robbery	rob
rock	rock
rocker	rock
rocket	rocket
rocketry	rocket
roll	roll
roller	roll
rolling	roll
roof	roof
roofer	roof
roofing	roof
room	room
rooms	room
roomer	room
roomful	room
roost	roost
rooster	roost
root	root
rooting	root
rot	rot
rotor	rot
rotting	rot
rottenness	rot
rough	rough
roughage	rough
roughness	rough
round	round
roundness	round
rout	rout	route
route	rout	route
row	row
rower	row
rowing	row
rubber	rubber
rubberization	rubber
rubbish	rubbish
ruin	ruin
ruiner	ruin
ruining	ruin
ruination	ruin
rule	rule
ruler	rule
ruling	rule
rumor	rumor
rumour	rumour
run	run
running	run
runniness	run
rush	rush
rushing	rush
rust	rust
rusting	rust
sabotage	sabotage
safeguard	safeguard
sail	sail
sailor	sail
sailing	sail
sale	sell
sell	sell
sales	sell
seller	sell
selling	sell
salability	sell
salt	salt
salting	salt
salvage	salvage
salvager	salvage
sample	sample
sampler	sample
sampling	sample
sanction	sanction
sand	sand
sands	sand
sandal	sand
sander	sand
sandwich	sandwich
sandwichman	sandwich
satellite	satellite
satisfying	satisfy
satisfaction	satisfy
sauce	sauce
saucer	sauce
save	save
savor	save
saver	save
savant	save
saving	save
savings	save
savoring	save
savvy	savvy
saw	saw
sawyer	saw
say	say
saying	say
scale	scale
scalar	scale
scales	scale
scaling	scale
scantness	scant
scare	scare
schedule	schedule
scheduling	schedule
scheme	scheme
schemer	scheme
school	school
schooling	school
schoolman	school
scourge	scourge
scramble	scramble
scrambler	scramble
scrap	scrap	scrape
scrape	scrap	scrape
scraps	scrap	scrape
scraper	scrap	scrape
scraping	scrap	scrape
scratch	scratch
scratching	scratch
screen	screen
screening	screen
seal	seal
sealer	seal
sealant	seal
sealing	seal
search	search
searcher	search
searching	search
season	season
seasoner	season
seasoning	season
seasonableness	season
seat	seat
seats	seat
seating	seat
second	second
seconder	second
secondary	second
secondment	second
section	section
sectionalism	section
sectionalisation	section
sectionalization	section
security	secure
securement	secure
secureness	secure
see	see	sight
seer	see	sight
seism	see	sight
sight	see	sight
seance	see	sight
seeing	see	sight
sighting	see	sight
seed	seed
seeder	seed
seedman	seed
seek	seek
seeker	seek
seeking	seek
segment	segment
segmentation	segment
segregant	segregate
segregation	segregate
seizer	seize
seizing	seize
seizure	seize
selector	select
selection	select
selectman	select
selectivity	select
sender	send
sending	send
sense	sense
sensor	sense
sensing	sense
sensation	sense
sensitizer	sense
sensitivity	sense
sensitizing	sense
sensitisation	sense
sensitiveness	sense
sensitization	sense
sentence	sentence
separate	separate
separator	separate
separation	separate
separatist	separate
separability	separate
separateness	separate
serve	serve	service
serval	serve	service
server	serve	service
servant	serve	service
service	serve	service
serving	serve	service
services	serve	service
servicing	serve	service
serviceman	serve	service
serviceability	serve	service
serviceableness	serve	service
set	set
setting	set
settle	settle
settler	settle
settling	settle
settlement	settle
sex	sex
sexism	sex
sexist	sex
shade	shade
shades	shade
shading	shade
shadiness	shade
shadow	shadow
shadowing	shadow
shaft	shaft
shake	shake
shaker	shake
shaking	shake
shakiness	shake
shallow	shallow
shallowness	shallow
shame	shame
shamefulness	shame
shape	shape
shaper	shape
shaping	shape
share	share
sharer	share
sharing	share
shed	shed
shedding	shed
sheet	sheet
sheeting	sheet
shelf	shelve
shelfful	shelve
shelving	shelve
shell	shell
shelling	shell
shield	shield
shielding	shield
shift	shift
shifting	shift
ship	ship
shipment	ship
shipping	ship
shock	shock
shocker	shock
shoe	shoe
shoal	shoe
shoes	shoe
shop	shop
shopping	shop
shore	shore
shoring	shore
short	short
shorts	short
shortage	short
shortness	short
shortening	shorten
shot	shoot
shoot	shoot
shooter	shoot
shooting	shoot
shoulder	shoulder
show	show
showing	show
showman	show
showiness	show
shrimp	shrimp
shrink	shrink
shrinkage	shrink
shrinking	shrink
shrug	shrug
shuffle	shuffle
shuffler	shuffle
shuffling	shuffle
shunning	shun
shutting	shut
shuttle	shuttle
shy	shy
shiite	shy
shyness	shy
sick	sick
sickness	sick
side	side
siding	side
sidetrack	sidetrack
siege	siege
sign	sign	signal
signal	sign	signal
signer	sign	signal
signor	sign	signal
signing	sign	signal
signaler	sign	signal
signaling	sign	signal
signature	sign	signal
signalman	sign	signal
signaller	sign	signal
signalization	sign	signal
silver	silver
simplification	simplify
single	single
singles	single
singleness	single
sink	sink
sinker	sink
sinkage	sink
sinking	sink
sitting	sit
site	site
size	size
sizing	size
skate	skate
skater	skate
skates	skate
skating	skate
ski	ski
skis	ski
skier	ski
skiing	ski
skin	skin
skinful	skin
skirt	skirt
sky	sky
skyrocket	skyrocket
slack	slack
slacks	slack
slacker	slack
slacking	slack
slackness	slack
slap	slap
slash	slash
slashing	slash
slate	slate
slater	slate
slating	slate
slaughter	slaughter
slaughterer	slaughter
sleep	sleep
sleeper	sleep
sleeping	sleep
slew	slew
slews	slew
slice	slice
slicer	slice
slicing	slice
slick	slick
slickness	slick
slide	slide
slider	slide
slight	slight
slightness	slight
slimness	slim
slip	slip
slippage	slip
slipperiness	slip
slowing	slow
slowness	slow
slump	slump
smack	smack
smacker	smack
smacking	smack
smart	smart
smarting	smart
smartness	smart
smoke	smoke
smoker	smoke
smoking	smoke
smooth	smooth
smoother	smooth
smoothness	smooth
snack	snack
snake	snake
snap	snap
snare	snare
sneak	sneak
sneaker	sneak
sneakiness	sneak
snow	snow
snowman	snow
snowball	snowball
soap	soap
soar	soar
soaring	soar
sod	sod
softener	soften
softening	soften
soil	soil
soilage	soil
soilure	soil
soiling	soil
sole	sole
solicitor	solicit
solicitation	solicit
solicitousness	solicit
solute	solve
solvate	solve
solvent	solve
solving	solve
solution	solve
solvency	solve
solvation	solve
sooth	soothe
sort	sort
sorter	sort
sorting	sort
sound	sound
sounding	sound
soundman	sound
soundness	sound
soup	soup
sour	sour
souring	sour
sourness	sour
sow	sow
sower	sow
space	space
spacing	space
spaceman	space
spaceship	space
spatiality	space
span	span
spare	spare
spareness	spare
spark	spark
speech	speak
speaker	speak
speaking	speak
spearhead	spearhead
special	specialise	specialize
specialty	specialise	specialize
speciality	specialise	specialize
specialism	specialise	specialize
specialist	specialise	specialize
specializer	specialise	specialize
specialness	specialise	specialize
specialisation	specialise	specialize
specialization	specialise	specialize
specific	specify
specifying	specify
specificity	specify
specification	specify
speculator	speculate
speculation	speculate
speculativeness	speculate
speed	speed
speeder	speed
speeding	speed
spell	spell
speller	spell
spelling	spell
spender	spend
spending	spend
spike	spike
spill	spill
spilth	spill
spillage	spill
spin	spin
spinal	spin
spinning	spin
spindle	spindle
spiral	spiral
spirit	spirit
spirits	spirit
spiritual	spirit
spiritualist	spirit
spirituality	spirit
spiritualism	spirit
spiritualisation	spirit
spiritualization	spirit
spirt	spirt
spit	spit
spitting	spit
spite	spite
spitefulness	spite
splinter	splinter
splinters	splinter
splintering	splinter
split	split
splurge	splurge
sponsor	sponsor
sponsorship	sponsor
sport	sport
sports	sport
spot	spot
spotting	spot
spotlight	spotlight
spread	spread
spreader	spread
spreading	spread
spree	spree
spring	spring
springer	spring
spur	spur
spurring	spur
spurt	spurt
spy	spy
spying	spy
squabble	squabble
square	square
squareness	square
squash	squash
squeeze	squeeze
squeezer	squeeze
stable	stable	stabilise	stabilize
stabile	stable	stabilise	stabilize
stabling	stable	stabilise	stabilize
stableman	stable	stabilise	stabilize
stability	stable	stabilise	stabilize
stabilizer	stable	stabilise	stabilize
stableness	stable	stabilise	stabilize
stabilisation	stable	stabilise	stabilize
stabilization	stable	stabilise	stabilize
staff	staff
staffer	staff
stage	stage
stager	stage
staging	stage
stagnation	stagnate
stake	stake
stakes	stake
staking	stake
stalemate	stalemate
stall	stall
stalls	stall
stalling	stall
stallion	stall
stamp	stamp
stand	stand	station
stance	stand	station
stands	stand	station
station	stand	station
standing	stand	station
stationer	stand	station
standoff	standoff
staple	staple
stapler	staple
star	star
starboard	starboard
starch	starch
start	start
starter	start
starting	start
state	state
stator	state
statement	state
staunchness	staunch
stave	stave
stay	stay
stays	stay
stayer	stay
stayman	stay
steady	steady
steadiness	steady
steal	steal
stealing	steal
steam	steam
steamer	steam
steamship	steam
steel	steel
steelman	steel
steep	steep
steepness	steep
steer	steer
steering	steer
stem	stem
step	step
steps	step
stereotype	stereotype
sterility	sterilise
sterileness	sterilise
sterilisation	sterilise
sterilization	sterilise
steward	steward
stewardship	steward
stick	stick
sticker	stick
stickiness	stick
stiffener	stiffen
stiffening	stiffen
stifle	stifle
stifling	stifle
still	still
stillness	still
stimulant	stimulate
stimulation	stimulate
stipulation	stipulate
stir	stir
stirring	stir
stock	stock
stocks	stock
stocker	stock
stockist	stock
stockman	stock
stocking	stock
stockpile	stockpile
stockpiling	stockpile
stomach	stomach
stomacher	stomach
stone	stone
stonewaller	stonewall
stonewalling	stonewall
stop	stop
stops	stop
stoppage	stop
stopping	stop
store	store
stores	store
storage	store
storing	store
storm	storm
straddle	straddle
strain	strain
strainer	strain
straining	strain
stream	stream
streamer	stream
streaming	stream
streamline	streamline
streamliner	streamline
stress	stress
stretch	stretch
stretcher	stretch
stretching	stretch
strife	strive
striver	strive
striving	strive
strike	strike
striker	strike
striking	strike
strip	strip
striper	strip
stripping	strip
strengthener	strengthen
strengthening	strengthen
struggle	struggle
study	study
studying	study
stuff	stuff
stuffing	stuff
style	style
stylist	style
stylite	style
stylisation	style
stylishness	style
stylization	style
sub	sub
subbing	sub
subcontract	subcontract
subcontractor	subcontract
subdue	subdue
subdual	subdue
subject	subject
subjection	subject
subjectivity	subject
subjectiveness	subject
submittal	submit
submission	submit
submissive	submit
submissiveness	submit
subordinate	subordinate
subordination	subordinate
subordinateness	subordinate
subscribe	subscribe
subscript	subscribe
subscriber	subscribe
subcription	subscribe
subscription	subscribe
subsidy	subside	subsidize	subsidise
subsiding	subside	subsidize	subsidise
subsidence	subside	subsidize	subsidise
subsidisation	subside	subsidize	subsidise
subsidization	subside	subsidize	subsidise
substance	substantiate
substantiation	substantiate
substantiality	substantiate
substantialness	substantiate
substitute	substitute
substituting	substitute
substitution	substitute
substitutability	substitute
success	succeed
successor	succeed
succession	succeed
successfulness	succeed
successiveness	succeed
suck	suck
sucker	suck
sucking	suck
suction	suck
suit	sue	suit
suite	sue	suit
suitor	sue	suit
suiting	sue	suit
sufferer	suffer
suffering	suffer
sufferance	suffer
sufficiency	suffice
sugar	sugar
suggestion	suggest
suggestibility	suggest
sulphur	sulphur
sulphuration	sulphur
sulfurisation	sulphur
sulphurization	sulphur
sum	sum
summation	sum
summer	summer
sun	sun
supervise	supervise
supervisor	supervise
supervising	supervise
supervision	supervise
supplanter	supplant
supplanting	supplant
supplantation	supplant
supplement	supplement
supplementation	supplement
supply	supply
supplier	supply
supplies	supply
suppliant	supply
supplying	supply
support	support
supporter	support
supporting	support
supposal	suppose
supposition	suppose
surcharge	surcharge
surface	surface
surfacing	surface
surge	surge
surpass	surpass
surprise	surprise
surprisal	surprise
surprising	surprise
surrender	surrender
survey	survey
surveyor	survey
surveying	survey
survival	survive
survivor	survive
suspect	suspect
suspicion	suspect
suspense	suspend
suspender	suspend
suspension	suspend
suspenders	suspend
sustenance	sustain
sustinence	sustain
sustainment	sustain
sustainability	sustain
swamp	swamp
swap	swap
sway	sway
sweep	sweep
sweeper	sweep
sweeping	sweep
sweetener	sweeten
sweetening	sweeten
swell	swell
swelling	swell
swing	swing
swinger	swing
swinging	swing
swirl	swirl
switch	switch
switching	switch
switchman	switch
symbol	symbolize
symbolism	symbolize
symbolist	symbolize
symbolizing	symbolize
symbolisation	symbolize
symbolization	symbolize
sympathy	sympathise
sympathizer	sympathise
syndic	syndicate
syndicate	syndicate
syndicalism	syndicate
syndication	syndicate
table	table
tableful	table
taboo	taboo
tack	tack
tacking	tack
tackle	tackle
tackler	tackle
tackling	tackle
tag	tag
tailor	tailor
tailoring	tailor
take	take
taker	take
taking	take
takings	take
talc	talc
talk	talk
talks	talk
talker	talk
talking	talk
talkativeness	talk
tally	tally
tallyman	tally
tangle	tangle
tanglement	tangle
tank	tank
tankage	tank
tankful	tank
tap	tap
taps	tap
tapping	tap
tape	tape
taping	tape
taper	taper
tapering	taper
tar	tar
target	target
tariff	tariff
task	task
taste	taste
taster	taste
tasting	taste
tastiness	taste
tastefulness	taste
tat	tat
tater	tat
tatting	tat
tax	tax
taxman	tax
taxation	tax
taxi	taxi
taxis	taxi
taximan	taxi
teach	teach
teacher	teach
teaching	teach
team	team
telephone	telephone
telephoner	telephone
telephonist	telephone
telex	telex
tell	tell
teller	tell
telling	tell
temper	temper
tempera	temper
tempering	temper
temperance	temper
temperament	temper
temperateness	temper
tempter	tempt
temptress	tempt
temptation	tempt
tenant	tenant
tenancy	tenant
tending	tend
tendency	tend
tendance	tend
tendentiousness	tend
tender	tender
tenderizer	tender
tenderness	tender
tenderisation	tender
tenderization	tender
tense	tense
tensor	tense
tension	tense
tenseness	tense
term	term
terms	term
termes	term
termite	term
terminal	terminate
terminator	terminate
termination	terminate
test	test
testee	test
tester	test
testing	test
testifier	testify
testification	testify
thaw	thaw
thawing	thaw
thinness	thin
thinning	thin
think	think
thought	think
thinker	think
thinking	think
thoughtfulness	think
threat	threaten
throttle	throttle
throttling	throttle
throw	throw
thrower	throw
thrust	thrust
thruster	thrust
thrusting	thrust
thwart	thwart
thwarting	thwart
ticket	ticket
tide	tide
tiding	tide
tidings	tide
tie	tie	tying
tier	tie	tying
tying	tie	tying
tightening	tighten
tile	tile
tiling	tile
till	till
tiller	till
tillage	till
tilling	till
time	time
timer	time
times	time
timing	time
timetable	timetable
tin	tin
tinful	tin
tinning	tin
tinker	tinker
tip	tip
tire	tire
tiresomeness	tire
tissue	tissue
title	title
tolerance	tolerate
toleration	tolerate
tolerability	tolerate
toll	toll
toller	toll
tollman	toll
tone	tone
tongue	tongue
tool	tool
top	top
topee	top
toper	top
topping	top
total	total
totalism	total
totality	total
totaliser	total
totalizer	total
totalisator	total
totalisation	total
totalitarian	total
totalization	total
totalitarianism	total
touch	touch
touching	touch
tour	tour
tourer	tour
tourism	tour
touring	tour
tourist	tour
tow	tow
tower	tower
toy	toy
toying	toy
trace	trace
tracer	trace
tracery	trace
tracing	trace
traction	trace
track	track
tracker	track
tracking	track
trade	trade
trader	trade
trading	trade
traffic	traffic
trafficker	traffic
trafficator	traffic
train	train
trainee	train
trainer	train
trainful	train
training	train
trainman	train
transparent	transparent
transparence	transparent
transparency	transparent
transparentness	transparent
transfer	transfer
transferral	transfer
transference	transfer
transferability	transfer
transform	transform
transformer	transform
transformation	transform
transit	transit
transition	transit
transitivity	transit
transitiveness	transit
translator	translate
translation	translate
transmittal	transmit
transmitter	transmit
transmission	transmit
transmitting	transmit
transmittance	transmit
transpiration	transpire
transponder	transponder
transport	transport
transporter	transport
transportation	transport
trash	trash
travel	travel
traveler	travel
traveling	travel
traveller	travel
travelling	travel
tread	tread
treat	treat
treatment	treat
tree	tree
tremor	tremor
trench	trench
trencher	trench
trend	trend
trespass	trespass
trespasser	trespass
triangle	triangle
trickle	trickle
trigger	trigger
trim	trim
trimer	trim
trimming	trim
trimness	trim
trip	trip
triple	triple
tripling	triple
trouble	trouble
troubling	trouble
troublesomeness	trouble
truck	truck
truckful	truck
trucking	truck
true	true
truth	true
truthfulness	true
trust	trust
trustee	trust
trustfulness	trust
try	try
trial	try
trier	try
tryst	try
tube	tube
tubing	tube
tug	tug
tumble	tumble
tumbler	tumble
tumbling	tumble
tune	tune
tuner	tune
tuning	tune
tunefulness	tune
tunnel	tunnel
turf	turf
turn	turn
turner	turn
turnery	turn
turning	turn
tussle	tussle
twin	twin
type	type
typing	type
typist	type
typifying	type
typicality	type
typification	type
undercut	undercut
underline	underline
underpin	underpin
underpinning	underpin
underscore	underscore
understand	understand
understanding	understand
understandability	understand
understatement	understate
undertaker	undertake
undertaking	undertake
underwriter	underwrite
uniform	uniform
uniformity	uniform
uniformness	uniform
universe	universe
universal	universe
university	universe
universalism	universe
universality	universe
universalisation	universe
universalization	universe
unlike	unlike
unlikeness	unlike
unloading	unload
unravelment	unravel
unsettlement	unsettle
unveiling	unveil
update	update
updating	update
upgrade	upgrade
uplift	uplift
uplifting	uplift
upliftment	uplift
upset	upset
upswing	upswing
urge	urge
urging	urge
urgency	urge
us	use
use	use
user	use
using	use
usance	use
usefulness	use
usurper	usurp
usurpation	usurp
utility	utilize
utilitarian	utilize
utilisation	utilize
utilization	utilize
utilitarianism	utilize
utterance	utter
vacation	vacate	vacation
vacationer	vacate	vacation
vacationing	vacate	vacation
vacationist	vacate	vacation
vaccine	vaccinate
vaccinating	vaccinate
vaccination	vaccinate
vacuum	vacuum
value	value
valuer	value
values	value
valuator	value
valuation	value
variant	vary
variate	vary
variable	vary
variance	vary
variation	vary
variability	vary
variational	vary
variableness	vary
vein	vein
avenger	avenge
vengeance	avenge
vengefulness	avenge
venture	venture
venturesomeness	venture
verge	verge
verification	verify
vest	vest
vesta	vest
vestal	vest
vestment	vest
veto	veto
vial	vying
view	view
viewer	view
viewers	view
viewing	view
violator	violate
violation	violate
violability	violate
visit	visit
visitor	visit
visitant	visit
visiting	visit
visitation	visit
visualizer	visualize
visualisation	visualize
visualization	visualize
voice	voice
void	void
voiding	void
voidance	void
vote	vote
voter	vote
voting	vote
voyage	voyage
voyager	voyage
wage	wage
wages	wage
wait	wait	await
waiter	wait	await
waiting	wait	await
waitress	wait	await
waiver	waive
wake	wake
waking	wake
wakefulness	wake
walk	walk
walker	walk
walking	walk
wall	wall
wan	wane
wane	wane
waning	wane
wanness	wane
wander	wander
wanderer	wander
wandering	wander
want	want
war	war
warship	war
ward	ward
warehouse	warehouse
warehouser	warehouse
warm	warm
warmth	warm
warmer	warm
warming	warm
warmness	warm
warning	warn
warrant	warrant
warrantee	warrant
warrantor	warrant
waste	waste
waster	waste
wasting	waste
wastefulness	waste
watch	watch
watcher	watch
watchman	watch
watching	watch
watchfulness	watch
water	water
waters	water
watering	water
waterman	water
wave	wave
waving	wave
waver	waver
waverer	waver
wavering	waver
wax	wax
waxing	wax
weakening	weaken
weaning	wean
wear	wear
wearer	wear
wearing	wear
weariness	weary
weather	weather
weatherman	weather
wedge	wedge
weed	weed
weeds	weed
weekend	weekend
weekender	weekend
weeper	weep
weeping	weep
weepiness	weep
weight	weigh	weight
weighing	weigh	weight
weighting	weigh	weight
welcome	welcome
welcoming	welcome
well	well
wet	wet
wetness	wet
wetting	wet
whack	whack
whacker	whack
whacking	whack
whale	whale
wheel	wheel
wheels	wheel
wheeler	wheel
wheeling	wheel
while	while
whip	whip
whipping	whip
white	white
whiting	white
whiteness	white
wholesale	wholesale
wholesaler	wholesale
widening	widen
wildcat	wildcat
wildcatting	wildcat
will	will
willing	will
willfulness	will
win	win
winning	win
winnings	win
winsomeness	win
wind	wind
winder	wind
winding	wind
wine	wine
winery	wine
winemaker	wine
winemaking	wine
wing	wing
wings	wing
winger	wing
wingman	wing
winter	winter
winterisation	winter
winterization	winter
wipe	wipe
wiper	wipe
wire	wire
wiring	wire
wish	wish
wishing	wish
wishfulness	wish
wit	witness
witness	witness
withdrawal	withdraw
withdrawnness	withdraw
withholding	withhold
wonder	wonder
wonderment	wonder
wonderfulness	wonder
word	word
words	word
wording	word
work	work
works	work
worker	work
workman	work
working	work
workings	work
worry	worry
worrier	worry
worrying	worry
worriment	worry
worsening	worsen
worst	worst
worsted	worst
wound	wound
wounded	wound
wounding	wound
wrangle	wrangle
wrangler	wrangle
wrangling	wrangle
wrap	wrap
wrapping	wrap
wreck	wreck
wrecker	wreck
wrecking	wreck
wrench	wrench
wring	wring
wringer	wring
wrinkle	wrinkle
writer	write
writing	write
writings	write
wrong	wrong
wrongdoer	wrong
wrongness	wrong
wrongdoing	wrong
wrongfulness	wrong
yarn	yarn
yellow	yellow
yellowness	yellow
yen	yen
yield	yield
yielding	yield
zero	zero
zone	zone
zoning	zone
>>> 