abandonment	abandon
abasement	abase
abashment	abash
abatement	abate
abbreviation	abbreviate
abdication	abdicate
abducent	abduce
abduction	abduct
aberration	aberrate
abetment	abet
abhorrence	abhor
abidance	abide
abirritation	abirritate
abjuration	abjure
ablation	ablate
abnegation	abnegate
abolishment	abolish
abomination	abominate
abortion	abort
abundance	abound
about-face	about-face
abrasiveness	abrade	abrase
abreaction	abreact
abridgement	abridge
abrogation	abrogate
abscission	abscise
abscondment	abscond
absenteeism	absent
absoluteness	absolve
absorptivity	absorb
abstinence	abstain
abstractness	abstract
abuser	abuse
abutment	abut
abies	aby
ace	ace
accedence	accede
acceleration	accelerate
accentuation	accent	accentuate
acceptableness	accept
accessibility	access	accession
acclamation	acclaim
acclimation	acclimate
acclimatization	acclimatise	acclimatize
accommodation	accommodate
accompaniment	accompany
accomplishment	accomplish
accordance	accord
accountability	account
accouterment	accouter
accoutrement	accoutre
accreditation	accredit
accretion	accrete
accruement	accrue
acculturation	acculturate
accumulation	accumulate
accusative	accuse
acerbation	acerbate
acetification	acetify
acetylation	acetylate	acetylize
aching	ache
achievability	achieve
achromatization	achromatise	achromatize
acidification	acidify
acidulousness	acidulate
acieration	acierate
acknowledgement	acknowledge
acquaintance	acquaint
acquiescence	acquiesce
acquisitiveness	acquire
acquittance	acquit
actress	act
activeness	activate
actualization	actualise	actualize
actuation	actuate
acumination	acuminate
adaptability	adapt
additive	add
addiction	addict
addressee	address
adduction	adduce	adduct
adhesiveness	adhere
adhibition	adhibit
adjournment	adjourn
adjudgment	adjudge
adjudication	adjudicate
adjuration	adjure
adjustment	adjust
admeasurement	admeasure
administration	administer	administrate
administeration	administerate
admirableness	admire
admissibility	admit
admixture	admix
admonishment	admonish
adoption	adopt
adorableness	adore
adornment	adorn
adsorption	adsorb
adulation	adulate
adulteration	adulterate
adumbration	adumbrate
advancement	advance
advantageousness	advantage
adventurousness	adventure
advertizing	advert	advertize
advertisement	advertise
advisability	advise
advocation	advocate
aeration	aerate
aerification	aerify
aerosol	aerosolize
aestivation	aestivate
affectionateness	affect
affiliation	affiliate
affirmativeness	affirm
affixation	affix
affliction	afflict
afforestation	afforest
affranchisement	affranchise
affright	affright
affront	affront
africanization	africanise	africanize
afrikanerization	afrikanerise	afrikanerize
ageing	age
agglomeration	agglomerate
agglutination	agglutinate
aggradation	aggrade
aggrandizement	aggrandise	aggrandize
aggravation	aggravate
aggregation	aggregate
aggressiveness	aggress
aggrievement	aggrieve
agitation	agitate
agnation	agnate
agonization	agonize
agonisation	agonise
agreement	agree
aides	aid
ailment	ail
aim	aim
air-conditioning	air-condition
airship	air
airbrush	airbrush
airlift	airlift
airmail	airmail
alarmist	alarm
alchemization	alchemize
alcoholization	alcoholize	alcoholise
alertness	alert
alibi	alibi
alienation	alien	alienate
alignment	align
alimentation	aliment
alinement	aline
alkalinization	alkalinize
alkalizer	alkalize
alkalification	alkalify
allegement	allege
allegorization	allegorize	allegorise
alleviation	alleviate
alligator	alligator
alliteration	alliterate
allocation	allocate
allotment	allot
allowance	allow	allowance
alloy	alloy
allusiveness	allude
allurement	allure
alliance	ally
alphabetization	alphabetise	alphabetize
alterability	alter
altercation	altercate
alternative	alternate
aluminization	aluminize
amalgamation	amalgamate
amassment	amass
amazement	amaze
ambition	ambition
amble	amble
ambulation	ambulate
ambuscade	ambuscade
ambush	ambush
amelioration	ameliorate
amendment	amend
amercement	amerce
americanization	americanise	americanize
ammoniation	ammoniate
ammonification	ammonify
amnesty	amnesty
amortization	amortize
amortisation	amortise
amount	amount
amplification	amplify
amputation	amputate
amusement	amuse
anaesthetization	anaesthetize
anagrams	anagram
anagrammatization	anagrammatize
analogization	analogize
analyzation	analyse	analyze
anastomosis	anastomose
anathematization	anathematise	anathematize
anatomization	anatomise	anatomize
anchorman	anchor
anchylosis	anchylose
anesthetization	anesthetize
angriness	anger
angularity	angle
anglicization	anglicise	anglicize
anguish	anguish
angulation	angulate
animadversion	animadvert
animalization	animate	animize	animalise	animalize
ankylosis	ankylose
annealing	anneal
annexation	annex
annihilation	annihilate
annotation	annotate
announcement	announce
annoyance	annoy
annulment	annul
annunciation	annunciate
anodization	anodize
anointment	anoint
answerableness	answer
ante	ante
antagonization	antagonise	antagonize
antecedency	antecede
antelope	antelope
anteroom	anteroom
anteversion	antevert
anthologization	anthologize
anthropomorphization	anthropomorphize
antic	antic
anticipation	anticipate
antidote	antidote
antiquation	antique	antiquate
aper	ape
aphorization	aphorize
apocopation	apocopate
apologetics	apologise	apologize
apostasy	apostatize
apostrophization	apostrophize
apotheosization	apotheose	apotheosize
appalling	appal	appall
apparel	apparel
appellative	appeal
appearance	appear
appeasement	appease
appendicitis	append
apperception	apperceive
appertainment	appertain
applauder	applaud
applique	applique
applicability	apply
appointment	appoint
apportionment	apportion
appositeness	appose
appraiser	appraise
appreciativeness	appreciate
apprehensiveness	apprehend
apprenticeship	apprentice
apprisal	apprise	apprize
approachability	approach
approbation	approbate
appropriateness	appropriate
approving	approve
approximation	approximate
aquaplane	aquaplane
aquatint	aquatint
arbitrager	arbitrage
arbitrement	arbitrate
arbor	arborize
arc	arc
archness	arch
archaization	archaize
archives	archive
argumentation	argue
argufication	argufy
armament	arm	armor
armourer	armour
aromatization	aromatise	aromatize
arousal	arouse
arraignment	arraign
arrangement	arrange
arrayal	array
arrester	arrest
arriver	arrive
arrogation	arrogate
arterialization	arterialise	arterialize
article	article
articulateness	articulate
ascendency	ascend
ascertainment	ascertain
ascription	ascribe
ash	ash
asking	ask
aspersion	asperse
asphalt	asphalt
asphyxiation	asphyxiate
aspiration	aspire	aspirate
assailability	assail
assassination	assassinate
assault	assault
assayal	assay
assembling	assemble
assenting	assent
assertiveness	assert
assessment	assess
asseveration	asseverate
assibilation	assibilate
assignation	assign
assimilation	assimilate
assistance	assist
associableness	associate
assoilment	assoil
assortment	assort
assuagement	assuage
assumption	assume
assurance	assure
asterisk	asterisk
astonishment	astonish
astriction	astrict
protestation	protest
atomization	atomise	atomize
atonicity	atone
atrophy	atrophy
attachment	attach
attacker	attack
attainableness	attain
attempt	attempt
attentiveness	attend
attenuation	attenuate
attestation	attest
attire	attire
attitudinization	attitudinize
attornment	attorn
attractiveness	attract
attribution	attribute
attunement	attune
auctioneer	auction	auctioneer
audition	audit	audition
augmentation	augment
augury	augur
auscultation	auscultate
auspices	auspicate
authentication	authenticate
authoritarianism	author	authorise	authorize
autoclave	autoclave
autograph	autograph
automatization	automate	automatize
automobile	automobile
autopsy	autopsy
autotomization	autotomize
availableness	avail
avalanche	avalanche
averment	aver
averageness	average
averting	avert
aviation	aviate
avoidance	avoid
avouchment	avouch
avowal	avow
avulsion	avulse
awfulness	awe
awakening	awaken
awarding	award
axe	ax	axe
azure	azure
baas	baa
babbitt	babbitt
babblement	babble
baby	baby
babysitting	babysit
bach	bach
bachelor	bachelor
backing	back
backbiter	backbite
backfill	backfill
backfire	backfire
backgrounding	background
backhand	backhand
backlash	backlash
backlog	backlog
backorder	backorder
backpacking	backpack
backsliding	backslide
backspacer	backspace
backstitch	backstitch
backstop	backstop
backup	backup
bacterization	bacterize
badge	badge
badgering	badger
bafflement	baffle
bagging	bag
bayer	bay
bailment	bail
baiting	bait
baking	bake
balancing	balance
baldness	bald
balefulness	bale
balk	balk
balkanization	balkanise	balkanize
ball	ball
ballast	ballast
balloonist	balloon
balloting	ballot
ballyhoo	ballyhoo
bamboozlement	bamboozle
banning	ban
banding	band
bandaging	bandage
banging	bang
banishment	banish
banking	bank
bankroll	bankroll
bankruptcy	bankrupt
banqueting	banquet
banter	banter
baptists	baptise	baptize
barring	bar
barb	barb
barbarousness	barbarize
barbarisation	barbarise
barbecuing	barbecue
barber	barber
bard	bard
bareness	bare
bargaining	bargain
bargeman	barge
barker	bark
barkeeper	barkeep
barnstormer	barnstorm
barracking	barrack
barrage	barrage
barrelful	barrel
barricade	barricade
bartender	bartend
barterer	barter
baseness	base
bashfulness	bash
basification	basify
basset	basset
bastion	baste
bastardization	bastardize
bastardisation	bastardise
bastinado	bastinado
batting	bat
batch	batch
bathing	bath	bathe
batik	batik
batten	batten
battering	batter
battleship	battle
baulk	baulk
bawling	bawl
bayonet	bayonet
being	be
bestialization	bestialize
beach	beach
beachcomber	beachcomb
beacon	beacon
beading	bead
beak	beak
beam	beam
bearing	bear
beard	beard
beating	beat
beatification	beatify
beautification	beautify
beaver	beaver
bebop	bebop
bedding	bed
bedazzlement	bedazzle
bedevilment	bedevil
bedizenment	bedizen
beef	beef
beep	beep
beeswax	beeswax
beetle	beetle
befooling	befool
befoulment	befoul
befuddlement	befuddle
beggarman	beg	beggar
beginning	begin
beguilement	beguile
behaviorism	behave
beheading	behead
beholding	behold
belay	belay
belching	belch
beleaguerment	beleaguer
belie	belie
believability	believe
belittlement	belittle
bellman	bell
bellowing	bellow
bellyful	belly
bellyacher	bellyache
belongings	belong
beloved	belove
belting	belt
bemusement	bemuse
bench	bench
bending	bend
beneficiary	benefice
benefaction	benefit
bequest	bequeath
berating	berate
bereavement	bereave
berry	berry
berth	berth
besieging	besiege
besprinkling	besprinkle
best	best
bestowment	bestow
bet	bet
betrayer	betray
betrothed	betroth
betterment	better
bevel	bevel
bewilderment	bewilder
bewitchment	bewitch
bias	bias
bib	bib
bickering	bicker
bicyclist	bicycle
bidding	bid
biff	biff
bifurcation	bifurcate
bight	bight
bike	bike
bilges	bilge
billions	bill
billet	billet
billow	billow
binful	bin
binding	bind
binge	binge
bio-assay	bio-assay
bioassay	bioassay
birch	birch
birding	bird
birdie	birdie
birdlime	birdlime
birdnesting	birdnest
birling	birl	birle
birr	birr
birthing	birth	birthe
bisection	bisect
bishop	bishop
bistate	bistate
bitch	bitch
biter	bite
bitt	bitt
bitterness	bitter
bituminization	bituminise	bituminize
bivouac	bivouac
blackness	black
blackball	blackball
blackberry	blackberry
blackening	blacken
blackguard	blackguard
blackjack	blackjack
blackleg	blackleg
blacklist	blacklist
blackmailer	blackmail
blacktopping	blacktop
blame	blame
blandishment	blandish
blankness	blank
blanket	blanket
blaring	blare
blarney	blarney
blasphemer	blaspheme
blast	blast
blather	blather
blazing	blaze
blazonment	blazon
bleach	bleach
bleat	bleat
bleeding	bleed
bleep	bleep
blemishment	blemish
blending	blend
blessing	bless
blether	blether
blighter	blight
blindness	blind
blindfold	blindfold
blinker	blink	blinker
blister	blister
blitz	blitz
bloat	bloat
blob	blob
blocking	block
blockade	blockade
blood	blood	bloody
blooming	bloom
blossoming	blossom
blot	blot
blotch	blotch
blowing	blow
blubber	blubber
bludgeon	bludgeon
blueness	blue
blueprint	blueprint
bluffness	bluff
blunderer	blunder
bluntness	blunt
blur	blur
blurt	blurt
blusher	blush
blusterer	bluster
boarding	board
boastfulness	boast
boatman	boat
bob	bob
bobsled	bobsled
bobsleigh	bobsleigh
bodement	bode
body	body
bodybuilding	bodybuild
bog	bog
bogeyman	bogey
boiling	boil
boldface	boldface
bollock	bollocks
bolshevism	bolshevize
bolster	bolster
bolt	bolt
bombing	bomb
bombardment	bombard
bondman	bond
boniness	bone
bong	bong
bonnet	bonnet
boo	boo
boob	boob
boogie	boogie
booking	book
bookbinding	bookbind
bookkeeping	bookkeep
bookselling	booksell
bookshelf	bookshelf
boomer	boom
boomerang	boomerang
boosters	boost
bootees	boot
bootlegging	bootleg
bootlicker	bootlick
bootstrap	bootstrap
boozing	booze
bop	bop
borderer	border
boredom	bore
borrowing	borrow
bosom	bosom
bossism	boss
botanization	botanize
botcher	botch
botheration	bother
bottleful	bottle
bottleneck	bottleneck
bottom	bottom
bounciness	bounce
boundary	bound
bowing	bow	bower
bowdlerization	bowdlerise	bowdlerize
bowling	bowl
boxing	box
boycott	boycott
bracing	brace
brachiation	brachiate
bracket	bracket
brad	brad
braggadocio	brag
braiding	braid
braille	braille
brain	brain
brainstorm	brainstorm
brainwashing	brainwash
braising	braise
brakeman	brake
embranchment	branch
branding	brand
brandishment	brandish
braving	brave
bravo	bravo
brawler	brawl
bray	bray
brazenness	brazen
broach	breach	broach
bread	bread
breadwinning	breadwin
breaking	break
breakfast	breakfast
bream	bream
breast	breast
breathing	breathe
breathalyser	breathalyse
breathalyzer	breathalyze
breeding	breed
breeziness	breeze
brevet	brevet
brewing	brew
bribery	bribe
brick	brick
bricklaying	bricklay
bridge	bridge
bridle	bridle
briefness	brief
brigade	brigade
brim	brim
brininess	brine
bringing	bring
briskness	brisk
bristle	bristle
broadcasting	broadcast
broadening	broaden
broadside	broadside
brocade	brocade
broiling	broil
broker	broker
bromation	bromate
bromination	brominate
bronze	bronze
brooch	brooch
brooding	brood
brook	brook
broom	broom
brownness	brown
browsing	browse
bruiser	bruise
bruit	bruit
brunch	brunch
brushing	brush
brutalization	brutalise	brutalize
bubbler	bubble
buccaneering	buccaneer
buck	buck
bucketful	bucket
buckler	buckle
buckram	buckram
budding	bud
budget	budget
buff	buff
buffalo	buffalo
buffer	buffer
buffeting	buffet
bug	bug
buggery	bugger
bugle	bugle
building	build
bulge	bulge
bulk	bulk
bullion	bull
bulldog	bulldog
bulldozer	bulldoze
bulletin	bulletin
bullshit	bullshit
bully-off	bully-off
bullying	bully
bulwarks	bulwark
bum	bum
bumbler	bumble
bumper	bump
bunch	bunch
bunco	bunco
bundling	bundle
bungee	bung
bungling	bungle
bunker	bunk	bunker
bunting	bunt
buoyancy	buoy
burring	bur	burr
burdensomeness	burden
burglarization	burgle	burglarise	burglarize
burying	bury
burl	burl
burlesque	burlesque
burning	burn
burnish	burnish
burping	burp
burrow	burrow
burster	burst
burthen	burthen
bussing	bus	buss
bushing	bush
bushel	bushel
bushwhacker	bushwhack
busker	busk
buster	bust
bustle	bustle
busyness	busy
butchering	butcher
butler	butler
butte	butt
butter	butter
button	button
buttonhole	buttonhole
buttressing	buttress
butyl	butylate
buying	buy
buzzer	buzz
bypass	bypass
cab	cab
cabalist	cabal
cabbage	cabbage
cabin	cabin
cable	cable
cache	cache
cachinnation	cachinnate
cackler	cackle
caddis	caddy	caddie
cadger	cadge
cager	cage
cajolement	cajole
cake	cake
cakewalk	cakewalk
calcification	calcify
calcimine	calcimine
calcination	calcine
calculability	calculate
calendar	calendar
calender	calender
calibration	calibrate
calipers	caliper
calk	calk
calling	call
callipers	calliper
callus	callus
calmness	calm
calumniation	calumniate
calving	calve
camber	camber
camouflage	camouflage
campion	camp
campaigning	campaign
camphoration	camphorate
canning	can
cancan	cancan
cancellation	cancel
candle	candle
candy	candy
canalization	cane	canal	canalise	canalize
canker	canker
cannibalization	cannibalise	cannibalize
cannoneer	cannon
cannonade	cannonade
canoeist	canoe
canonization	canonise	canonize
canopy	canopy
cantor	cant
canter	canter
cantilever	cantilever
cantillation	cantillate
cantonment	canton
cannulization	canulate	cannulate
canvas	canvas
canvassing	canvass
caption	cap	caption
capacitation	capacitate
caparison	caparison
caper	caper
capitalization	capitalize
capitalisation	capitalise
capitulation	capitulate
caponization	caponize
caponisation	caponise
capsizing	capsize
capsulation	capsulate
captainship	captain
captivation	captivate
capture	capture
caramelization	caramelize
caravanning	caravan
carbonization	carbonate	carbonize
carboxylation	carboxylate
carburization	carburet	carburise	carburize
cards	card
carefulness	care
careenage	careen
careerist	career
caressing	caress
caricaturist	caricature
carminative	carmine
carnality	carnalize
carnification	carnify
caroller	carol
carom	carom
carouser	carouse
carping	carp
carpentry	carpenter
carpeting	carpet
carriage	carry
carting	cart
cartoon	cartoon
cartwheel	cartwheel
carving	carve
cascades	cascade
casement	case
caseation	caseate
cash	cash
cashier	cashier
casket	casket
casting	cast
castigation	castigate
castling	castle
castration	castrate
cat	cat
catabolism	catabolize
cataloger	catalog
cataloguer	catalogue
catalysis	catalyze
catapult	catapult
catcall	catcall
catchment	catch
catechization	catechize
categorization	category	categorize	categorise
catenation	catenate
catering	cater
caterwaul	caterwaul
catheterization	catheterise	catheterize
catholicization	catholicise	catholicize
catnap	catnap
caucus	caucus
caulking	caulk
causation	cause
causeway	causeway
cauterization	cauterise	cauterize
caution	caution
caving	cave
cavern	cavern
caw	caw
cessation	cease
cession	cede
celebration	celebrate
cellar	cellar
cementation	cement
censorship	censor
censure	censure
census	census
centralization	center	centre	centralize
centigrade	centigrade
centrifugation	centrifuge	centrifugate
centuplication	centuplicate
ceres	cere
cerebration	cerebrate
certification	certify	certificate
chafing	chafe
chaff	chaff
chagrin	chagrin
chains	chain
chairman	chair	chairman
chalk	chalk
challenger	challenge
chamber	chamber
champ	champ
championship	champion
chance	chance
changefulness	change
channelization	channel	channelize
chanting	chant
chapman	chap
chaperonage	chaperon	chaperone
char	char
characterization	character	characterize
characterisation	characterise
charcoal	charcoal
charger	charge
charioteer	chariot
charmer	charm
chartist	chart
charterage	charter
chaser	chase
chasse	chasse
chastisement	chasten	chastise
chat	chat
chattering	chatter
chauffeur	chauffeur
chaw	chaw
cheating	cheat
checkers	check	checker
checkmate	checkmate
cheekful	cheek
cheep	cheep
cheerfulness	cheer
cheerleading	cheerlead
cheese	cheese
chelation	chelate
chemisorption	chemisorb
cheque	cheque
chevy	chevy
chewing	chew
chicanery	chicane
chiding	chide
chilling	chill
chime	chime
chin	chin
chine	chine
chink	chink
chipping	chip
chirp	chirp
chirrup	chirrup
chiseller	chisel
chitchat	chitchat
chlorination	chlorinate
chloroform	chloroform
chock	chock
choiceness	choose
choir	choir
choking	choke
chomping	chomp
chondrification	chondrify
chop	chop
chord	chord
choreographer	choreograph
chortle	chortle
chorus	chorus
christening	christen
christianization	christianise	christianize
christmas	christmas
chrome	chrome
chronicler	chronicle
chronology	chronologize
chuck	chuck
chuckle	chuckle
chug	chug
chum	chum
chunk	chunk
churchman	church
churn	churn
cicatrization	cicatrise	cicatrize
ciliation	ciliate
cinch	cinch
cinchonization	cinchonise	cinchonize
cinder	cinder
cinema	cinematize
cinematographer	cinematograph
cipher	cipher
circularization	circle	circularize	circularise
circuit	circuit
circulation	circulate
circumambulation	circumambulate
circumcision	circumcise
circumflex	circumflex
circumfusion	circumfuse
circumnavigation	circumnavigate
circumnutation	circumnutate
circumscription	circumscribe
circumstantiation	circumstantiate
circumvallation	circumvallate
circumvention	circumvent
circumvolution	circumvolute
citation	cite
cityfication	citify	cityfy
civilization	civilize
civilisation	civilise
clabber	clabber
clack	clack
cladding	clad
claimant	claim
clamoring	clam	clamor
clamber	clamber
clamouring	clamour
clamp	clamp
clangoring	clang	clangor
clangour	clangour
clank	clank
clapping	clap
clapboard	clapboard
clarification	clarify
clarion	clarion
clash	clash
clasp	clasp
class	class
classicism	classicize
classification	classify
clatter	clatter
claw	claw
claxon	claxon
clay	clay
cleanliness	clean
cleansing	cleanse
clearness	clear
cleat	cleat
cleavers	cleave
clench	clench
clerkship	clerk
clew	clew
click	click
climax	climax
climbing	climb
clincher	clinch
cling	cling
clinker	clink	clinker
clipping	clip
cloak	cloak
clobber	clobber
clocking	clock
clog	clog
cloister	cloister
clone	clone
closeness	close	closure	cloture
closet	closet
clotting	clot
clothing	clothe
clouding	cloud	clouded
clout	clout
clowning	clown
clubbing	club
cluck	cluck
clue	clue
clump	clump
clunk	clunk
cluster	cluster
clutches	clutch
clutter	clutter
co-star	co-star
coachman	coach
coagulation	coagulate
coalman	coal
coalescency	coalesce
coarsening	coarsen
coaster	coast
coating	coat
coaxing	coax
cobbling	cobble
cocainization	cocainise	cocainize
cocker	cock	cocker
cockle	cockle
cockneyfication	cocknify	cockneyfy
cocoon	cocoon
cod	cod
codling	coddle
coding	code
codification	codify
coercion	coerce
coexistence	coexist
coextension	coextend
coffin	coffin
cog	cog
cogitation	cogitate
cognisance	cognise
cognizance	cognize
cohabitation	cohabit
cohesiveness	cohere
coif	coif
coiffure	coiffure
coil	coil
coinage	coin
coincidence	coincide
coinsurance	coinsure
coke	coke
collaboration	collaborate
collapse	collapse
collar	collar
collation	collate
collective	collect
collectivization	collectivise	collectivize
collision	collide
colligation	colligate
collimation	collimate
collocation	collocate
collusion	collude
collie	colly
colonization	colonize
coloration	color	colorate
colouring	colour
combativeness	comb
combatant	combat
combination	combine
combustible	combust
coming	come
comfit	comfit
comfortableness	comfort	comfortable
commandment	command	commandeer
commemoration	commemorate
commencement	commence
commendation	commend
commentation	comment	commentate
commercialization	commercialise	commercialize
comminglement	commingle
comminution	comminute
commiseration	commiserate
commissioning	commit	commission
commixture	commix
communalization	commune	communalise	communalize
communization	communize
communicativeness	communicate
commutability	commute	commutate
compactness	compact
companionableness	companion
company	company
comparability	compare
compartment	compart
compartmentalization	compartmentalise	compartmentalize
compassionateness	compass	compassionate
compulsiveness	compel	compell
compensation	compensate
compere	compere
competitiveness	compete
compilation	compile
complainant	complain
complementation	complement
completeness	complete
complexifier	complexify
complexion	complexion
complication	complicate
compliments	compliment
compliancy	comply
comportment	comport
composition	compose
compost	compost
compounding	compound
comprehensiveness	comprehend
compressibility	compress
comprising	comprise
compromise	compromise
computation	compute
computerization	computerise	computerize
con	con
concatenation	concatenate
concealment	conceal
concession	concede
concelebration	concelebrate
concentricity	concentrate
conceivableness	conceive
conceptualization	conceptualise	conceptualize
concert	concert	concertize
concertina	concertina
conciliation	conciliate
conclusiveness	conclude
concoction	concoct
concordance	concord
concretization	concrete	concretize
concern	concrn	concern
concurrence	concur
concussion	concuss
condamnation	condamn
condemnation	condemn
condensation	condense	condensate
condescendence	condescend
conditionality	condition
condolement	condole
condonation	condone
conductivity	conduct
cone	cone
confab	confab
confabulation	confabulate
confection	confect	confection
confederation	confederate
conferment	confer
confession	confess
confidentiality	confide
configuration	configure
confinement	confine
confirmation	confirm
confiscation	confiscate
conflation	conflate
confliction	conflict
conformation	conform
confounding	confound
confrontation	confront
confusion	confuse
confutation	confute
conge	conge
conga	conga
congelation	congeal
congestion	congest
conglobation	conglobe	conglobate
conglomeration	conglomerate
conglutination	conglutinate
congratulations	congratulate
congregation	congregate
conjecture	conjecture
conjunctivitis	conjoin
conjugation	conjugate
conjuration	conjure
conker	conk
connective	connect
connivance	connive
connotation	connote
conquering	conquer
conscription	conscript
consecration	consecrate
consensus	consent
conservative	conserve
considerateness	consider
consignation	consign
consistency	consist
consociation	consociate
consolement	console
consolidation	consolidate
consort	consort
conspirator	conspire
constellation	constellate
consternation	consternate
constipation	constipate
constitutional	constitute
constitutionalism	constitutionalize
constraint	constrain
constriction	constrict
constringency	constringe
structuralization	construct	structure	structuralize
construal	construe
consubstantiation	consubstantiate
consultation	consult
consumptive	consume
consummation	consummate
contacting	contact
containerful	contain
containerization	containerise	containerize
contamination	contaminate
contemptibility	contempt
contemplativeness	contemplate
contemporaneousness	contemporize
contentiousness	contend	content
contestation	contest
continuousness	continue
contortion	contort
contour	contour
contraband	contraband
contracting	contract
contradiction	contradict
contradistinction	contradistinguish
contraindication	contraindicate
contrast	contrast
contravention	contravene
contredanse	contredanse
contribution	contribute
contrivance	contrive
controlling	control
controversion	controvert
contusion	contuse
convalescence	convalesce
convection	convect
convention	convene
conveniences	convenience
conventionalization	conventionalise	conventionalize
convergency	converge
convertibility	convert
conversation	converse
conveyance	convey
convincement	convict	convince
convocation	convoke
convolution	convolve	convolute
convoy	convoy
convulsion	convulse
coo	coo
cooking	cook
coolness	cool
coop	coop
cooperativeness	cooper	cooperate	co-operate
co-optation	coopt	co-opt
coordination	coordinate	co-ordinate
cop	cop
coping	cope
copolymerization	copolymerise	copolymerize
copper	copper
copulative	copulate
copyist	copy
copyreader	copyread
copyright	copyright
coquetry	coquet
coquette	coquette
corbel	corbel
cordite	cord
cordon	cordon
corduroys	corduroy
coral	core
corker	cork
corkscrew	corkscrew
corn	corn
corner	corner
cornice	cornice
coronation	coronate
corrasion	corrade
corral	corral
correctitude	correct
correlativity	correlate
correspondence	correspond
corroboration	corroborate
corrosive	corrode
corrugation	corrugate
corruptibility	corrupt
corsetry	corset
cortication	corticate
coruscation	coruscate
cosh	cosh
costing	cost
costume	costume
cotton	cotton
couch	couch
coughing	cough
counseling	counsel
counterman	count	counter
countenance	countenance
counteraction	counteract
counterattack	counterattack
counterbalance	counterbalance
counterchange	counterchange
countercheck	countercheck
counterclaim	counterclaim
counterfeiter	counterfeit
countermand	countermand
countermine	countermine
countermovement	countermove
counterplot	counterplot
counterpoint	counterpoint
counterpoise	counterpoise
countersignature	countersign
countersink	countersink
counterweight	counterweight
country-dance	country-dance
country	country	countrify
coupe	coup
coupling	couple
coursing	course
court-martial	court-martial
courtship	court
covenant	covenant
covering	cover
covetousness	covet
cowman	cow
coward	coward
cowhide	cowhide
cowling	cowl
cox	cox
cozenage	cozen
crabs	crab
cracking	crack
cracklings	crackle
cradle	cradle
crafter	craft
cramp	cramp
crane	crane
crank	crank
craps	crap
crape	crape
crash-landing	crash-land
crasher	crash
crateful	crate	crater
craving	crave
crawfish	crawfish
crawling	crawl
crayon	crayon
craze	craze
creaking	creak
creamer	cream
crease	crease
creationism	create
crediting	credit
creeping	creep
cremation	cremate
crenellation	crenel	crenelate	crenellate
creosote	creosote
crepe	crepe
crepitation	crepitate
crescendo	crescendo
crest	crest
crewman	crew
crib	crib
crick	crick
cricketer	cricket
criminalness	criminate	criminalize
crimper	crimp
crimson	crimson
crinkle	crinkle
cripple	cripple
crispness	crisp
crisscross	crisscross
criticalness	critique	criticise	criticize
croaking	croak
crocheting	crochet
crock	crock
crook	crook
crooning	croon
crop	crop
croquet	croquet
cross-dresser	cross-dress
cross-examination	cross-examine
cross-fertilization	cross-fertilize
cross-index	cross-index
cross-pollination	cross-pollinate
cross-questioning	cross-question
cross-reference	cross-refer
crossness	cross
crossbreed	crossbreed
crosscheck	crosscheck
crosscut	crosscut
crosshatching	crosshatch
crouch	crouch
crowing	crow
crowding	crowd
crown	crown
crucifixion	crucify
cruiser	cruise
crumb	crumb
crunch	crunch
crusader	crusade
crushing	crush
crust	crust
crying	cry
crystallization	crystalize	crystallize
cub	cub
cubist	cube
cuckoldry	cuckold
cuckoo	cuckoo
cuddling	cuddle
cudgel	cudgel
cue	cue
cuffs	cuff
cull	cull
culmination	culminate
cultivation	cultivate
culture	culture
cumulation	cumulate
cupping	cup
curarization	curarise	curarize
curbing	curb
curdling	curdle
cure	cure
curettement	curet
curling	curl
curry	curry
cursor	curse
curtailment	curtail
curtain	curtain
curtsey	curtsey
curtsy	curtsy
curvature	curve
curvet	curvet
cushioning	cushion
cuss	cuss
customization	customize
cutting	cut
cutinization	cutinise	cutinize
cybernation	cybernate
cyclicity	cycle
cyclostyle	cyclostyle
cypher	cypher
dab	dab
dabbler	dabble
dalliance	dally
dam	dam
damages	damage
damascene	damascene
damnation	damn
damnification	damnify
dampness	damp
dampening	dampen
dancing	dance
dandification	dandify
dangling	dangle
dapple	dapple
daring	dare
darkening	darken
darning	darn
darter	dart
dash	dash
date	date
dateline	dateline
daubing	daub
dauntlessness	daunt
dawdling	dawdle
dawning	dawn
daydreamer	daydream
daze	daze
dazzle	dazzle
de-escalation	de-escalate
de-iodination	de-iodinate
deactivation	deactivate
deadening	deaden
deafness	deaf
dealings	deal
deaminization	deaminate	deaminize
debarring	debar
debarkation	debark
debasement	debase
debater	debate
debauchery	debauch
debilitation	debilitate
debit	debit	debite
debouchment	debouch
debriefing	debrief
debunking	debunk
debut	debut
decalcification	decalcify
decampment	decamp
decanter	decant
decapitation	decapitate
decarbonization	decarbonate	decarbonise	decarbonize
decarburization	decarburise	decarburize
decay	decay
deceased	decease
deceptiveness	deceive
deceleration	decelerate
december	december
decentralisation	decentralise
decentralization	decentralize
decisiveness	decide
decimalization	decimate	decimalise	decimalize
decipherment	decipher
decking	deck
declamation	declaim
declarative	declare
declassification	declassify
declination	decline
decoction	decoct
decoding	decode
decollation	decollate
decolonization	decolonize
decolorization	decolor	decolour	decolorize
decomposition	decompose
decompression	decompress
deconstruction	deconstruct
decontamination	decontaminate
decontrol	decontrol
decorativeness	decorate
decortication	decorticate
decoy	decoy
decrease	decrease
decrement	decree	decrement
decrepitation	decrepitate
decrescendo	decrescendo
decrial	decry
decryption	decrypt
decussation	decussate
dedication	dedicate
deductible	deduce	deduct
deeds	deed
deepening	deepen
deepfreeze	deepfreeze
defacement	deface
defalcation	defalcate
defamation	defame
defaulter	default
defeasance	defeat
defecation	defecate
defectiveness	defect
defensibility	defend
deferment	defer
defilement	defile
definiteness	define
deflagration	deflagrate
deflation	deflate
deflection	deflect
deflocculation	deflocculate
defoliation	defoliate
deforcement	deforce
deforestation	deforest
deformation	deform
defraudation	defraud
defrayment	defray
defroster	defrost
defusing	defuse
defiance	defy
degaussing	degauss
degemination	degeminate
degeneration	degenerate
deglutination	deglutinate
degradation	degrade
degustation	degust	degustate
dehiscence	dehisce
dehumanization	dehumanise	dehumanize
dehumidification	dehumidify
dehydration	dehydrate
dehydrogenization	dehydrogenate
dehypnotization	dehypnotise	dehypnotize
deicer	deice
deification	deify
dejection	deject
delamination	delaminate
delation	delate
delay	delay
delegation	delegate
deletion	delete
deli	delie
deliberateness	deliberate
delight	delight
delimitation	delimit	delimitate
delineation	delineate
deliquescence	deliquesce
deliverance	deliver
delocalization	delocalise	delocalize
delusion	delude
deluge	deluge
demagnetization	demagnetise	demagnetize
demander	demand
demarcation	demarcate
demeanor	demean
demerit	demerit
demilitarization	demilitarise	demilitarize
demise	demise
demister	demist
demission	demit
demo	demo
demobilization	demobilise	demobilize
democratization	democratise	democratize
demodulation	demodulate
demolishment	demolish
demonization	demonize
demonetization	demonetise	demonetize
demonstrativeness	demonstrate
demoralization	demoralise	demoralize
demotion	demote
demulsification	demulsify
demureness	demur
demythologization	demythologise	demythologize
denationalization	denationalise	denationalize
denaturalization	denature	denaturalise	denaturalize
denazification	denazify
denicotinization	denicotinize
denigration	denigrate
denitration	denitrate
denitrification	denitrify
denomination	denominate
denotement	denote
denunciation	denounce	denunciate
dentist	dent
denudation	denude	denudate
denier	deny
deodorization	deodorise	deodorize
deoxidization	deoxidise	deoxidize
deoxygenation	deoxygenate
department	depart
departmentalization	departmentalise	departmentalize
dependableness	depend
depersonalization	depersonalise	depersonalize
depiction	depict	depicture
depilation	depilate
depletion	deplete
deployment	deploy
deplumation	deplume	deplumate
depolarization	depolarise	depolarize
deponent	depone
depopulation	depopulate
deportation	deport
deposition	depose	deposit
depravation	deprave
deprecation	deprecate
depreciation	depreciate
depredation	depredate
depressive	depress
deprivation	deprive
depuration	depurate
deputization	depute	deputize
deputisation	deputise
deracination	deracinate
darraignment	deraign	darraign
derailment	derail
derangement	derange
derate	derat	derate
deregulation	deregulate
derision	deride
derivative	derive
derogation	derogate
desalinization	desalinate	desalinize
descant	descant
descendants	descend
description	describe
desecration	desecrate
desegregation	desegregate
desensitization	desensitise	desensitize
desertion	desert
desexualization	desexualise	desexualize
desiccation	desiccate
desideration	desiderate
designation	design	designate
desirableness	desire
desistence	desist
desolation	desolate
desorption	desorb
desperation	despair
despatch	despatch
despicableness	despise
despoliation	despoil
despondency	despond
despotism	despot
despumation	despumate
desquamation	desquamate
dessication	dessicate
desterilization	desterilize
destination	destine
destructiveness	destroy	destruct
desulfurization	desulfurize
desulphurization	desulphurise	desulphurize
desynchronization	desynchronize
detachment	detach
detailing	detail
detention	detain
detective	detect
deterrence	deter
deterioration	deteriorate
determinateness	determine	determinate
detestation	detest
dethronement	dethrone
detonation	detonate
detour	detour
detoxification	detoxify	detoxicate
detraction	detract
detrainment	detrain
detribalization	detribalise	detribalize
detrusion	detrude
detruncation	detruncate
deuteration	deuterate
devaluation	devalue	devaluate
devastation	devastate
development	develop
divestiture	devest	divest
deviation	deviate
devising	devise
devilment	devil	devilize
devitalization	devitalise	devitalize
devitrification	devitrify
devocalization	devocalize
devolvement	devolve
devotement	devote
devourer	devour
diabolization	diabolise	diabolize
diagnostics	diagnose
diagonalization	diagonalize
diagramming	diagram
dial	dial
dialog	dialog
dialogue	dialogue
dialysation	dialyse
dialyzer	dialyze
diaper	diaper
diazotization	diazotise	diazotize
dibble	dibble
diction	dice
dichotomisation	dichotomise
dichotomization	dichotomize
dictation	dictate
die-casting	die-cast
dietetics	diet
differentiation	differ	differentiate
diffraction	diffract
diffuseness	diffuse
diggings	dig
digestibleness	digest
digitalization	digitate	digitize	digitise	digitalise	digitalize
dignification	dignify
digression	digress
dike	dike
dilapidation	dilapidate
dilatation	dilate
dillydallier	dillydally
dilution	dilute
dimness	dim
dimension	dimension
dimidiation	dimidiate
diminutiveness	diminish
dimple	dimple
dining	din	dine
ding	ding	dinge
dip	dip
diphthongization	diphthongise	diphthongize
directorate	direct
dirtiness	dirty
disablement	disable
disabusal	disabuse
disaccord	disaccord
disadvantage	disadvantage
disaffection	disaffect
disaffiliation	disaffiliate
disaffirmation	disaffirm
disafforestment	disafforest
disagreeableness	disagree
disallowance	disallow
disannulment	disannul
disappearance	disappear
disappointment	disappoint
disapproval	disapprove
disarmament	disarm
disarrangement	disarrange
disarray	disarray
disarticulation	disarticulate
disassembly	disassemble
disavowal	disavow
disbandment	disband
disbarment	disbar
disbeliever	disbelieve
disburdenment	disburden
disbursement	disburse
discarding	discard
discernability	discern
discharge	discharge
discipline	discipline
disclamation	disclaim
disclosure	disclose
discoloration	discolor	discolorize
discolouration	discolour
discombobulation	discombobulate
discomfiture	discomfit
discommendation	discommend
discomposure	discompose
disconcertment	disconcert
disconnection	disconnect
disconsideration	disconsider
disconsolateness	disconsole
discontentment	discontent
discontinuation	discontinue
discordance	discord
discount	discount
discouragement	discourage
discourse	discourse
discoverer	discover
discredit	discredit
discrimination	discriminate
discussion	discuss
disdainfulness	disdain
disembarkation	disembark
disembarrassment	disembarrass
disembodiment	disembody
disemboguement	disembogue
disembowelment	disembowel
disenablement	disenable
disenchantment	disenchant
disencumberment	disencumber
disendowment	disendow
disenfranchisement	disenfranchise
disengagement	disengage
disentailment	disentail
disentanglement	disentangle
disenthrallment	disenthral	disenthrall
disestablishment	disestablish
disesteem	disesteem
disfavor	disfavor
disfavour	disfavour
disfeaturement	disfeature
disfigurement	disfigure
disforestation	disforest
disfranchisement	disfranchise
disgorgement	disgorge
disgracefulness	disgrace
disgruntlement	disgruntle
disguise	disguise
disgust	disgust
dishful	dish
disheartenment	dishearten
dishevelment	dishevel
dishonorableness	dishonor
dishonourableness	dishonour
disillusionment	disillusion
disinclination	disincline
disinfection	disinfect
disinfestation	disinfest
disinheritance	disinherit
disintegration	disintegrate
disinterment	disinter
disinterest	disinterest
disjunction	disjoin
disjoint	disjoint
disk	disk
dislike	dislike
dislocation	dislocate
dislodgement	dislodge
dismantlement	dismantle
dismastment	dismast
dismay	dismay
dismemberment	dismember
dismission	dismiss
dismount	dismount
disobedience	disobey
disobligation	disoblige
disorder	disorder
disorganization	disorganize
disorientation	disorient	disorientate
disownment	disown
disparagement	disparage
dispatcher	dispatch
dispensableness	dispense
dispersion	disperse
displacement	displace
display	display
displeasure	displease
disposition	dispose
dispossession	dispossess
disproving	disprove
disproportionment	disproportion
disputation	dispute
disqualification	disqualify
disquiet	disquiet
disregard	disregard
disrelish	disrelish
disremembrance	disremember
disrepair	disrepair
disrespect	disrespect
disrobement	disrobe
disruption	disrupt
dissatisfaction	dissatisfy
dissection	dissect
dissemblance	dissemble
dissemination	disseminate
dissidence	dissent
dissertation	dissertate
disservice	disserve
disseveration	dissever
dissimilation	dissimilate
dissimulation	dissimulate
dissipation	dissipate
disassociation	dissociate	disassociate
dissoluteness	dissolve
dissuasion	dissuade
distaff	distaff
distance	distance
distemper	distemper
distention	distend
distillation	distil	distill
distinctiveness	distinguish
distortion	distort
distraction	distract
distrainment	distrain
distressfulness	distress
distribution	distribute
district	district
distrustfulness	distrust
disturbance	disturb
disunion	disunite
disuse	disuse
ditch	ditch
dithering	dither
ditto	ditto
divagation	divagate
divarication	divaricate
dive-bombing	dive-bomb
diving	dive
divergency	diverge
diversification	diversify
diverseness	divert	diverse
divisibility	divide
divinization	divine	divinise	divinize
divorcement	divorce
divulgement	divulge	divulgate
divvy	divvy
dizenment	dizen
dizziness	dizzy
dj	dj
donee	do	don
docking	dock
docket	docket
doctorate	doctor
documentation	document
dodderer	dodder
dodging	dodge
dog	dog
dogmatization	dogmatise	dogmatize
dogsled	dogsled
dolefulness	dole
doll	doll
domestication	domesticate	domesticize
domicile	domicile
domiciliation	domiciliate
domination	dominate	domineer
donation	donate
dong	dong
doodle	doodle
doomed	doom
dope	dope
dose	dose
dot	dot
double-check	double-check
double-crossing	double-cross
double-dealing	double-date
double-spacing	double-space
doubling	double
doubtfulness	doubt
douche	douche
dousing	douse
dovetail	dovetail
dower	dower
downer	down
downgrade	downgrade
download	download
downsizing	downsize
dowsing	dowse
dozer	doze
drafting	draft
dragee	drag
dragoonage	dragoon
drainage	drain
dramatization	dramatize
dramatisation	dramatise
drapery	drape
draughts	draught
drawing	draw
drawler	drawl
dreadfulness	dread
dreaming	dream
dredger	dredge
drenching	drench
dressing	dress
dribbling	dribble
drifting	drift
drilling	drill
drunkenness	drink	drunken
drippings	drip
driving	drive
driveller	drivel
drizzle	drizzle
droning	drone
drool	drool
droop	droop
droppings	drop
dropkicker	dropkick
drowsiness	drowse
drubbing	drub
drudgery	drudge
drugging	drug
drumming	drum
dry-cleaning	dry-clean
dryness	dry
dubbing	dub
dubbin	dubbin
ducking	duck
duelist	duel
dulcification	dulcify
dullness	dull
dummy	dummy
dumping	dump
dun	dun
dung	dung
dunkers	dunk
dupery	dupe
duplicability	duplicate
dustman	dust
dwarfism	dwarf
dwelling	dwell
dwindling	dwindle
dying	die	dying
dyeing	dye
dyke	dyke
dynamism	dynamize
dynamitist	dynamite
e-mail	e-mail
eaglet	eagle
earmark	earmark
earnings	earn
earthman	earth
easement	ease
edibleness	eat
ebb	ebb
ebonization	ebonize
echo	echo
ecliptic	eclipse
economization	economise	economize
eddy	eddy
edginess	edge
edification	edify
edition	edit
editorialization	editorialise	editorialize
education	educe	educate
edulcoration	edulcorate
effacement	efface
effectiveness	effect
effectualness	effectuate
effeminateness	effeminate	effeminize
effervescence	effervesce
efflorescence	effloresce
effusiveness	effuse
egestion	egest
eggs	egg
egression	egress
ejaculation	ejaculate
ejection	eject
elaborateness	elaborate
elastication	elasticate	elasticise	elasticize
elation	elate
elbowing	elbow
electorate	elect
electrification	electrify
electrocution	electrocute
electrodeposition	electrodeposit
electrolysation	electrolyse
electorlysis	electrolyze
electroplate	electroplate
elegization	elegize
elevation	elevate
elicitation	elicit
elision	elide
elimination	eliminate
eloignment	eloin	eloign
elongation	elongate
elopement	elope
elucidation	elucidate
elusiveness	elude
elution	elute
elutriation	elutriate
emaciation	emaciate
email	email
emanation	emanate
emancipation	emancipate
emasculation	emasculate
embalmment	embalm
embankment	embank
embargo	embargo
embarkation	embark
embarrassment	embarrass
embattlement	embattle
embayment	embay
imbedment	embed	imbed
embellishment	embellish
embezzlement	embezzle
embitterment	embitter
emblazement	emblaze
emblazonment	emblazon
emblematization	emblematize
embodiment	embody
emboldenment	embold	embolden
embossment	emboss
embowment	embow	embower
embowelment	embowel
embracement	embrace
embranglement	embrangle
embrocation	embrocate
embroiderer	embroider
embroilment	embroil
embruement	embrue
emcee	emcee
emendation	emend	emendate
emergency	emerge
emigration	emigrate
emission	emit
emotion	emote
emotionalization	emotionalise	emotionalize
empalement	empale
empanelment	empanel
emphasizing	emphasize
emplacement	emplace
employment	employ
empoisonment	empoison
empoverishment	empoverish
empowerment	empower
emptiness	empty
empurpled	empurple
emulation	emulate
emulsification	emulsify
emulsion	emulsion
enablement	enable
enactment	enact
enamel	enamel
encampment	encamp
incapsulation	encapsulate	incapsulate
incasement	encase	incase
encashment	encash
enchainment	enchain
enchantress	enchant
encipherment	encipher
encirclement	encircle
enclosure	enclose
encodement	encode
encompassment	encompass
encore	encore
encounter	encounter
encouragement	encourage
encroachment	encroach
incrustation	encrust	incrust
encryption	encrypt
incumbrance	encumber	incumber
encystation	encyst
ending	end
endamagement	endamage
endangerment	endanger
endearment	endear
endeavor	endeavor
endeavour	endeavour
endorsement	endorse
endowment	endow
endurance	endure
energization	energize
enervation	enervate
enfacement	enface
enfeeblement	enfeeble
enfeoffment	enfeoff
enfoldment	enfold
enforcement	enforce
enfranchisement	enfranchise
engagement	engage
engenderment	engender
engineering	engineer
engorgement	engorge
ingraftation	engraft	ingraft
engrailment	engrail
engraving	engrave
engrossment	engross
engulfment	engulf
enhancement	enhance
enjoinment	enjoin
enjoyableness	enjoy
enlacement	enlace
enlargement	enlarge
enlistment	enlist
enmeshment	enmesh
enmity	enmity
ennoblement	ennoble
enouncement	enounce
enplanement	enplane
enquirer	enquire
enragement	enrage
enrapturement	enrapture
enrichment	enrich
enrobement	enrobe
enrollment	enrol	enroll
enshrinement	enshrine	inshrine
ensilage	ensile
enslavement	enslave
ensnarement	ensnare
enswathement	enswathe
entailment	entail
entanglement	entangle
entrancement	enter	ingress	entrance
entertainment	entertain
enthrallment	enthral	enthrall
enthronization	enthrone
enthusiasm	enthuse
enticement	entice
entitlement	entitle
entoilment	entoil
entombment	entomb
entrainment	entrain
entrapment	entrap
intreatment	entreat	intreat
entrenchment	entrench
intrustment	entrust	intrust
entwintwinement	entwine	entwintwine
enucleation	enucleate
enumeration	enumerate
enunciation	enunciate
enurement	enure
envelopment	envelop	envelope
environment	environ
envisagement	envisage
envisioning	envision
envy	envy
epigrammatization	epigrammatize
epitomization	epitomize
epitomisation	epitomise
epoxy	epoxy
equalization	equal	equalise	equalize
equatability	equate
equilibration	equilibrate	equilibrize
equipping	equip
equipoise	equipoise
equiponderation	equiponderate
equivocalness	equivocate
eradiation	eradiate
eradication	eradicate
erasure	erase
erectness	erect
erosion	erode
erratum	err
eructation	eruct	eructate
eruption	erupt
escalade	escalade
escalation	escalate
escapement	escape
escarpment	escarp
escheatage	escheat
eschewal	eschew
escort	escort
espousal	espouse
espial	espy
esquire	esquire
essayist	essay
establishment	establish
esteem	esteem
esterification	esterify
estimation	estimate
estivation	estivate
estoppage	estop
estrangement	estrange
etching	etch
eternalization	eternize	eternalize
etherealization	etherise	etherize	etherealise	etherealize
etherification	etherify
ethylation	ethylate
etiolation	etiolate
etymologization	etymologize
euchre	euchre
euhemerization	euhemerize
eulogization	eulogize
euphemization	euphemize
euphonization	euphonize
europeanization	europeanize
europeanisation	europeanise
evacuation	evacuate
evasiveness	evade
evagination	evaginate
evaluation	evaluate
evanescence	evanesce
evangelization	evangelise	evangelize
evanishment	evanish
evaporation	evaporate
evenness	even
eventuation	eventuate
everting	evert
eviction	evict
evidence	evidence
evisceration	eviscerate
evocation	evoke
evolvement	evolve
exacerbation	exacerbate
exactitude	exact
exaggeration	exaggerate
exaltation	exalt
examination	examine
example	example
exasperation	exasperate
excavation	excavate
excessiveness	exceed
excellence	excel	excell
exception	except
excerption	excerpt
exchangeability	exchange
exciseman	excide	excise
excitableness	excite
exclamation	exclaim
exclusiveness	exclude
excogitation	excogitate
excommunication	excommunicate
excoriation	excoriate
excretion	excrete
excruciation	excruciate
exculpation	exculpate
excuse	excuse
execration	execrate
executioner	execute
exemplification	exemplify
exemption	exempt
exenteration	exenterate
exercitation	exercise
exertion	exert
exfoliation	exfoliate
exhalation	exhale
exhaustion	exhaust
exhibition	exhibit
exhilaration	exhilarate
exhortation	exhort
exhumation	exhume
exile	exile
existentialism	exist	existing
exit	exit
exoneration	exonerate
exorciser	exorcise	exorcize
expansiveness	expand
expatiation	expatiate
expatriation	expatriate
expectation	expect
expectoration	expectorate
expeditiousness	expedite	expedient
expulsion	expel	expell
expensiveness	expend
experimentation	experience	experiment
expertness	expertize
expiation	expiate
expiration	expire
explanation	explain
explantation	explant
explication	explicate
explosive	explode
exploitation	exploit
exploration	explore
exponentiation	exponentiate
exportation	export
exposition	expose	exposit
expostulation	expostulate
expounding	expound
expressiveness	express
expropriation	expropriate
expunction	expunge
expurgation	expurgate
exsection	exsect
exsertion	exsert
exsiccation	exsiccate
extemporization	extemporise	extemporize	extemporate
extensibility	extend
extent	extent
extenuation	extenuate
extermination	exterminate
exteriorization	exteriorise	exteriorize	externalise	externalize
extinction	extinct
extinguishment	extinguish
extirpation	extirpate
extolment	extol	extoll
extortioner	extort
extraction	extract
extradition	extradite
extrapolation	extrapolate
extravagation	extravagate
extravasation	extravasate
extrication	extricate
extrusion	extrude
exuberation	exuberate
exudation	exude	exudate
exultation	exult
exuviation	exuviate
eyeful	eye
eyeball	eyeball
fabrication	fabricate
faction	face
facilitation	facilitate
facsimile	facsimile
factorization	factor	factorise	factorize
fade-in	fade-in
fade-out	fade-out
fading	fade
fag	fag
failure	fail
faintness	faint
fairness	fair
fakeer	fake
falconry	falcon
falling	fall
falsification	falsify
faltering	falter
fame	fame
familiarization	familiarise	familiarize
famishment	famish
fanion	fan
fanaticization	fanaticize
fancier	fancy
fantasist	fantasize
farness	fare
faradization	faradise	faradize
farming	farm
farrowing	farrow
farting	fart
fascination	fascinate
fashioning	fashion
fastness	fast
fastening	fasten
fatness	fat
fates	fate
father	father
fathom	fathom
fatigues	fatigue
fault	fault
favorableness	favor
favourableness	favour
fawn	fawn
fax	fax
fearfulness	fear
feasting	feast
feathering	feather
featherbed	featherbed
feature	feature
fecundation	fecundate
federalization	federate	federalise	federalize
fee	fee
feeding	feed
feelings	feel
feigning	feign
feint	feint
felicitousness	felicitate
fellation	fell	fellate
felt	felt
feminization	feminize	feminise
fencing	fence
fender	fend
feoffment	feoff
fermentation	ferment
ferret	ferret
ferryman	ferry
fertilization	fertilize
fertilisation	fertilise
festering	fester
festoon	festoon
fetch	fetch
fetor	fete
fetter	fetter
feud	feud
feudalization	feudalise	feudalize
fever	fever
fibbing	fib
fictionalization	fictionalise	fictionalize
fiddler	fiddle
fidget	fidget
fielding	field
fighting	fight
figuration	figure
filing	file
filet	filet
filiation	filiate
filibusterer	filibuster
filling	fill
fillet	fillet
fillip	fillip
filmmaking	film
filtration	filter	filtrate
fins	fin
financing	finance	financier
finding	find
finalization	fine	finalize
finesse	finesse
fingering	finger
fingerprinting	fingerprint
finishing	finish
fink	fink
fieriness	fire
firebomb	firebomb
firmness	firm
first-footing	first-foot
fishing	fish
fissure	fissure
fistfight	fistfight
fitfulness	fit
fixative	fix	fixate
fizz	fizz
flagship	flag
flagellation	flagellate
flail	flail
flake	flake
flam	flam
flammability	flame
flameout	flameout
flank	flank
flannels	flannel
flapping	flap
flare	flare
flashing	flash
flatterer	flatter
flaunting	flaunt
flavouring	flavor	flavour
flaw	flaw
fleck	fleck
fledgling	fledge
fleece	fleece
fleetness	fleet
flesh	flesh
flection	flex
flicker	flick	flicker
flinch	flinch
fling	fling
flip-flop	flip-flop
flip	flip
flirtation	flirt
flit	flit
floatation	float
flocculation	flocculate
flock	flock
flogging	flog
flooding	flood
floodlight	floodlight
flooring	floor
flopping	flop
floss	floss
flounce	flounce
flounder	flounder
flour	flour
flourish	flourish
flowing	flow
flowering	flower
flub	flub
fluctuation	fluctuate
fluff	fluff
fluidization	fluidize
fluorescence	fluoresce
fluoridization	fluoridate	fluoridize
fluorination	fluorinate
flurry	flurry
flush	flush
fluster	fluster
flautist	flute
fluttering	flutter
flux	flux
fly-fishing	fly-fish
flying	fly	flee	flight
foal	foal
foam	foam
fob	fob
focalization	focalize
focus	focus
fodder	fodder
fog	fog
foiling	foil
folding	fold
foliation	foliate
following	follow
fomentation	foment
fondling	fondle
fool	fool
footman	foot
footnote	footnote
foozle	foozle
foraging	forage
foray	foray
forbearance	forbear
forbiddance	forbid
forcefulness	force
fording	ford
foreage	foreage
forearm	forearm
forebear	forebear
foreboding	forebode
forecasting	forecast
foreclosure	foreclose
foregrounding	foreground
foreknowledge	foreknow
foreordination	foreordain
forerunner	forerun
foresaw	foresaw
foresightfulness	foresee
foreshadowing	foreshadow
forestry	forest
forestallment	forestall
foretaste	foretaste
foretelling	foretell
foretoken	foretoken
forewarning	forewarn
forfeiture	forfeit
forging	forge
forgetfulness	forget
forgiveness	forgive	forgiven
forgoing	forgo
forejudgement	forjudge	forejudge
forking	fork
formatting	form	format
formalization	formalise	formalize
formication	formicate
formula	formulaize
formularization	formularise	formularize
formulization	formulate	formulize
fornication	fornicate
forsaking	forsake
forswearing	forswear
forte	fort
fortification	fortify
forwardness	forward
fossilization	fossilise	fossilize
fostering	foster
foulness	foul
foundering	found	founder
fowl	fowl
fox	fox
foxhunt	foxhunt
fractionization	fraction	fractionate	fractionize	fractionise
fracture	fracture
fragging	frag
fragmentation	fragment	fragmentize
framing	frame	frames
franchisement	franchise
frankness	frank
fraternization	fraternize
fray	fray
frazzle	frazzle
freak	freak
freckle	freckle
freeman	free
freelance	freelance
freeloader	freeload
freewheeler	freewheel
freighter	freight
frenchification	frenchify
frenzy	frenzy
frequentation	frequent
fresco	fresco
fretfulness	fret
fricassee	fricassee
frightfulness	fright	frighten
fringe	fringe
frisking	frisk
fritter	fritter
frivolousness	frivol
frizz	frizz
frock	frock
frolicsomeness	frolic
frontage	front
frosting	frost	freeze	freezing
frostbite	frostbite
froth	froth
frown	frown
fructification	fructify
fruitfulness	fruit
frustration	frustrate
frying	fry
ftp	ftp
fucking	fuck
fudge	fudge
fueling	fuel
fulfillment	fulfil	fulfill
fulguration	fulgurate
fullness	full
fullback	fullback
fulmination	fulminate
fumbler	fumble
fumes	fume
fumigation	fumigate
functionalism	function
funding	fund
funk	funk
funnel	funnel
furring	fur
furcation	furcate
furl	furl
furlough	furlough
furnishings	furnish
furrow	furrow
furtherance	further
fusion	fuse
fusillade	fusillade
fuss	fuss
fustigation	fustigate
gasification	gas	gasify
gab	gab
gabble	gabble
gad	gad
gaffer	gaff
gagman	gag
gage	gage
gaggle	gaggle
gainer	gain
gallantry	gall	gallant
gallicization	gallicize
gallicisation	gallicise
gallop	gallop
galvanization	galvanise	galvanize
gambling	gamble
gambol	gambol
gaminess	game
gander	gander
ganges	gang
gangrene	gangrene
gaol	gaol
gap	gap
gape	gape
garage	garage
garb	garb
garble	garble
gardening	garden
gargle	gargle
garland	garland
garment	garment
garner	garner
garnishment	garnish
garotte	garotte
garrison	garrison
garrotter	garrotte
garter	garter
gash	gash
gasp	gasp
gate	gate
gatecrasher	gatecrash
gathering	gather
gauffer	gauffer
gauge	gauge
gawk	gawk
gaze	gaze
gazetteer	gazette
gazump	gazump
gearing	gear
gee	gee
gel	gel
gelatinousness	gelatinise	gelatinize
gelding	geld
gemination	geminate
gemmation	gemmate
generalization	general	generalize
generation	generate
generalisation	generalise
gentleness	gentle
genuflection	genuflect
geologization	geologise	geologize
geometrization	geometrize	geometrise
germination	germinate
germanization	germanise	germanize
gerrymander	gerrymander
gestation	gestate
gesticulation	gesticulate
gesture	gesture
get-together	get-together
getting	get
geyser	geyser
ghost	ghost
ghostwriter	ghostwrite
gibber	gibber
gibbet	gibbet
gibe	gibe
givenness	gift	give
gig	gig
giggle	giggle
gilding	gild
gill	gill
gimbals	gimbal
gin	gin
ginger	ginger
girder	gird
girdle	girdle
girth	girth
glaciation	glaciate
glamorization	glamorize
glamour	glamour
glance	glance
glare	glare
glassful	glass
glazing	glaze
gleaming	gleam
gleaner	glean
gliding	glide
glimmering	glimmer
glimpse	glimpse
glint	glint
glissade	glissade
glisten	glisten
glister	glister
glitter	glitter
gloating	gloat
glorification	glory	glorify
gloss	gloss
gloves	glove
glowing	glow
glower	glower
glue	glue
glut	glut
gluten	glutenize
glutton	gluttonize
glycerine	glycerinate
glycerole	glycerolize
gnarl	gnarl
gnash	gnash
gnawer	gnaw
going	go
goading	goad
gobbler	gobble
goggles	goggle
gold-mining	gold	golden
golfing	golf
gondola	gondola
gong	gong
goof	goof
gosling	goose
goral	gore
gorge	gorge
gormandization	gormandize
gossiping	gossip
gouge	gouge
gourmand	gourmandize
government	govern
gown	gown
grab	grab
gracefulness	grace
gradation	grade	gradate
graduation	graduate
graffiti	graffiti
grafting	graft
granularity	grain
grangerization	grangerize
grangerisation	grangerise
grantor	grant
granulation	granulate
graphitization	graph	graphitise	graphitize
grappling	grapple
grasping	grasp
grass	grass
gratefulness	grate
gratification	gratify
gratulation	gratulate
graveness	grave
gravel	gravel
gravitation	gravitate
grayness	gray
grazing	graze
greasiness	grease
greenness	green
greeting	greet
greyness	grey
griddle	griddle
gridlock	gridlock
grievance	grieve
grilling	grill
grimace	grimace
griminess	grime
grinning	grin
grinding	grind
gripe	grip	gripe
grits	grit
grizzle	grizzle
groan	groan
groin	groin
grooming	groom
grooving	groove
grope	grope
grossness	gross
grouch	grouch
grounding	ground
grouping	group
grouse	grouse
grout	grout
groveller	grovel
growing	grow
growling	growl
grub	grub
grubstake	grubstake
grudge	grudge
grumbling	grumble
grunt	grunt
guarantee	guarantee
guaranty	guaranty
guarding	guard
guessing	guess
guesstimation	guesstimate
guest	guest
guffaw	guffaw
guy	guy
guidance	guide
guillotine	guillotine
gull	gull
gulping	gulp
gumming	gum
gunnery	gun
gurgle	gurgle
gusher	gush
gust	gust
guts	gut
gutter	gutter
gutturalization	gutturalise	gutturalize
guzzling	guzzle
gybe	gybe
gyps	gyp
gyration	gyrate
habilitation	habilitate
habitability	habit	habituate
hacker	hack
hackles	hackle
hackney	hackney
haggling	haggle
hail	hail
hairdressing	hairdress
hallmark	hallmark
halloo	halloo
hallucination	hallucinate
halogenation	halogenate
haltere	halt	halter
hamming	ham
hammering	hammer
hamper	hamper
hamstring	hamstring
handful	hand
handcraft	handcraft
handcuffs	handcuff
handicap	handicap
handling	handle
handstamp	handstamp
handwriting	handwrite
hangman	hang	hanging
hangar	hangar
hankering	hanker
hap	hap
happening	happen
harangue	harangue
harassment	harass
harbinger	harbinger
harbor	harbor
harbour	harbour
hardening	harden
hare	hare
harlequin	harlequin
harmfulness	harm
harmoniousness	harmonize	harmonise
harness	harness
harp	harp
harpooneer	harpoon
harrowment	harrow
harrier	harry
harvestman	harvest
hash	hash
hasp	hasp
hassle	hassle
hastiness	hasten
hatter	hat
hatching	hatch
hatefulness	hate
hauling	haul
haunt	haunt
have	have
haw	haw
hawking	hawk
haying	hay
hazardousness	hazard
haziness	haze
headship	head
headliner	headline
headquarters	headquarter
healing	heal
heaps	heap
hearing	hear
heating	heat
heathenization	heathenize
heaving	heave
hebetation	hebetate
hebraization	hebraise	hebraize
heckling	heckle
hectograph	hectograph
hector	hector
hedging	hedge
hedgehopping	hedgehop
hee-haw	hee-haw
heedfulness	heed
heel	heel
heft	heft
heist	heist
helicopter	helicopter
heliograph	heliograph
hellenization	hellenize
hellenisation	hellenise
helpfulness	help
hem	hem
hemagglutination	hemagglutinate
hemorrhage	hemorrhage
hemstitching	hemstitch
henna	henna
herald	herald
herder	herd
hesitation	hesitate
hewer	hew
hex	hex
hibachi	hibachi
hibernation	hibernate
hiccough	hiccough
hiccup	hiccup
hiding	hide
highness	heighten
highjacking	highjack
highlighting	highlight
hijacking	hijack
hiker	hike
hills	hill
hindrance	hinder
hinge	hinge
hint	hint
hiring	hire
hispanicisation	hispanicise
hispanicization	hispanicize
hissing	hiss
hitting	hit
hitch	hitch
hitchhiker	hitchhike
hives	hive
hoarding	hoard
hoaxer	hoax
hob	hob
hobble	hobble
hobnail	hobnail
hock	hock
hoe	hoe
hog	hog
hoist	hoist
holding	hold
hole	hole
holiday	holiday
hollering	holler
hollo	hollo
hollowness	hollow
holystone	holystone
homage	homage
homer	home	homer
homesteader	homestead
homogeneousness	homogenise	homogenize
homologization	homologate	homologize
honorableness	hone	honor
honey	honey
honeycomb	honeycomb
honeymooner	honeymoon
honker	honk
honourableness	honour
hood	hood
hoodooism	hoodoo
hoofing	hoof
hooker	hook
hoop	hoop
hooter	hoot
hoover	hoover
hops	hop
hopefulness	hope
horn	horn
horrification	horrify
horse	horse
horsewhipping	horsewhip
hose	hose
hospitalization	hospitalize
hospitalisation	hospitalise
host	host
hound	hound
housings	house
housebreaking	housebreak
housekeeping	housekeep
hover	hover
howling	howl
huckster	huckster
huddle	huddle
hue	hue
huff	huff
hugging	hug
hulk	hulk
hull	hull
humorousness	hum	humor
humanitarianism	humanise	humanize
humbleness	humble
humbuggery	humbug
humidification	humidify
humiliation	humiliate
humourist	humour
hump	hump
hunch	hunch
hungriness	hunger
hunting	hunt
hurdling	hurdle
hurling	hurl
hurrying	hurry
hurting	hurt
hurtle	hurtle
husbandman	husband
hush	hush
husking	husk
hustler	hustle
hybridization	hybridise	hybridize
hydration	hydrate
hydrogenization	hydrogenate	hydrogenise	hydrogenize
hydrolyzation	hydrolyse	hydrolyze
hydroplane	hydroplane
hygienics	hygienize
hymnal	hymn
hype	hype
hyperbolization	hyperbolise	hyperbolize
hypersensitization	hypersensitise	hypersensitize
hypertrophy	hypertrophy
hyperventilation	hyperventilate
hyphenization	hyphen	hyphenate	hyphenize
hypnotization	hypnotize
hypnotisation	hypnotise
hyposensitization	hyposensitise	hyposensitize
hypostatization	hypostatise	hypostatize
hypostasization	hypostasize
hypothecation	hypothecate
hypothesis	hypothesize
hysterectomy	hysterectomise	hysterectomize
iciness	ice
ideation	ideate
idealization	idealise	idealize
identification	identify
idleness	idle
idolization	idolise	idolize	idolatrise	idolatrize
ignition	ignite
ignorantness	ignore
ill-treatment	ill-treat
ill-use	ill-use
illegalization	illegalise	illegalize
illusion	illude
illumination	illume	illumine	illuminate
illustration	illustrate
imaginativeness	image	imagine
imbibition	imbibe
imbrication	imbricate
imbruembruement	imbrue	imbruembrue
imbuement	imbue
imitation	imitate
immaterialization	immaterialize
immediateness	immediate
immergence	immerge
immersion	immerse
immigration	immigrate
immixture	immix	immingle
immobilization	immobilise	immobilize
immolation	immolate
immortalization	immortalise	immortalize
immunization	immunise	immunize
immurement	immure
impaction	impact
impairment	impair
impalempalement	impale	impalempale
impanelment	impanel
impartation	impart
impassiveness	impassion
impastation	impaste
impeachability	impeach
impediment	impede
impulsiveness	impel	impulse
impendency	impend
imperilment	imperil
impersonalization	impersonate	impersonalise	impersonalize
impetration	impetrate
impingement	impinge
implantation	implant
implementation	implement
implosion	implode
imploration	implore
implication	imply	implicate
importation	import
importunity	importune
imposition	impose
imposture	imposture
impoundment	impound
impovempoverishment	impoverish	impovempoverish
imprecation	imprecate
impregnability	impregnate
impressiveness	impress
imprinting	imprint
imprisonment	imprison
impropriation	impropriate
improvement	improve
improvisation	improvise
impugnation	impugn
imputation	impute
inactivation	inactivate
inauguration	inaugurate
inboard	inboard
inbreeding	inbreed
incandescence	incandesce
incantation	incant
incapacitation	incapacitate
incarceration	incarcerate
incardination	incardinate
incarnation	incarnate
incensement	incense
inception	incept
inch	inch
incineration	incinerate
incisiveness	incise
incitement	incite
inclination	incline
inclosure	inclose
inclusion	include
incoming	income
inconvenience	inconvenience
incorporeality	incorporate
incrassation	incrassate
increase	increase
increment	increment
incrimination	incriminate
incubation	incubate
inculcation	inculcate
inculpableness	inculpate
incurableness	incur
incurvature	incurvate
indeed	indeed
indemnification	indemnify
indentation	indent	indenture
indexation	index
indicative	indicate
indictability	indict
indisposition	indispose
inditement	indite
individualization	individuate	individualise	individualize
indoctrination	indoctrinate
indorsement	indorse
inductance	induce	induct
indus	indue
indulgence	indulge
induration	indurate
industrialization	industrialise	industrialize
inebriation	inebriate
infantilism	infancy
infarction	infarct
infatuation	infatuate
infection	infect
inference	infer
infestation	infest
infielder	infield
infight	infight
infiltration	infiltrate
infirmity	infirm
infixation	infix
inflammation	inflame
inflation	inflate
inflection	inflect
infliction	inflict
inflow	inflow
influence	influence
infoldment	infold
information	inform
infraction	infract
infringement	infringe
infuriation	infuriate
infusion	infuse
ingathering	ingather
ingemination	ingeminate
ingeneration	ingenerate
ingestion	ingest
ingraining	ingrain
ingrate	ingrate
ingratiation	ingratiate
ingulfment	ingulf
ingurgitation	ingurgitate
inhabitation	inhabit
inhalation	inhale
inherence	inhere
inheritance	inherit
inhibition	inhibit
inholding	inhold
inhumation	inhume
initialization	initial	initiate	initialise	initialize
injection	inject
injuriousness	injure
ink	ink
inland	inland
inlay	inlay
inlet	inlet
inmate	inmate
innervation	innerve	innervate
innovativeness	innovate
inoculation	inoculate
inosculation	inosculate
input	input
inquest	inquest
inquisitiveness	inquire
insalivation	insalivate
inscription	inscribe
insemination	inseminate
insertion	insert
inset	inset
inshore	inshore
insider	inside
insightfulness	insight
insinuation	insinuate
insistency	insist
insnarement	insnare
insolation	insolate
inspectorate	inspect
inspiration	inspire
inspiritment	inspirit
inspissation	inspissate
installation	instal	install
instantiation	instance	instantiate
instatement	instate
instauration	instaurate
instep	instep
instigation	instigate
instillation	instil	instill
institution	institute
institutionalization	institutionalise	institutionalize
instructions	instruct
instrumentation	instrument	instrumentate
insufflation	insufflate
insulation	insulate
insult	insult
insurance	insure
intake	intake
integrating	integrate
intellectualization	intellectualise	intellectualize
intentness	intend	intent
inteneration	intenerate
intensiveness	intense
intensificatiion	intensify
interment	inter
interaction	interact
intercalation	intercalate
intercession	intercede
interception	intercept
interchangeableness	interchange
intercommunication	intercommunicate
interconnection	interconnect
interdependency	interdepend
interdiction	interdict
interest	interest
interference	interfere
interfusion	interfuse
intergradation	intergrade
interiorization	interiorize
interiorisation	interiorise
interjection	interject
interlacement	interlace
interlamination	interlaminate
interlineation	interline	interlineate
interlocking	interlock
interloper	interlope
interlude	interlude
intermarriage	intermarry
intermediation	intermediate
intermission	intermit
intermixture	intermix
internment	intern
internalization	internalise	internalize
internationalization	international	internationalise	internationalize
interosculation	interosculate
interpellation	interpellate
interpenetration	interpenetrate
interpolation	interpolate
interposition	interpose
interpretation	interpret
interrelationship	interrelate
interrogative	interrogate
interruption	interrupt
intersection	intersect
interspersion	intersperse
interstice	interstice
interstratification	interstratify
intertwinement	intertwine
intervention	intervene
interviewer	interview
interweavement	interweave
intimation	intimate
intimidation	intimidate
intonation	intone	intonate
intoxication	intoxicate
intrenchment	intrench
intrigue	intrigue
introduction	introduce
introjection	introject
intromission	intromit
introspectiveness	introspect
introversion	introvert
intrusiveness	intrude
intubation	intubate
intuition	intuit
intumescency	intumesce
intussusception	intussuscept
intwinement	intwine
inundation	inundate
inurement	inure
inurenurement	inurenure
inurnment	inurn
invasion	invade
invagination	invaginate
invalidation	invalid	invalidate
inveiglement	inveigle
inventiveness	invent
inventorying	inventory
inversion	invert	inverse
investment	invest
investigation	investigate
invigilation	invigilate
invigoration	invigorate
invitation	invite
invoice	invoice
invocation	invoke	invocate
involution	involute
involvement	involve
inwardness	inward
iodation	iodate
iodination	iodinate
iodization	iodise	iodize
ionisation	ionise
ionization	ionize
iridescence	iridesce
ironist	iron
irradiation	irradiate
irrigation	irrigate
irritability	irritate
irruption	irrupt
islamization	islamise	islamize
isolation	isolate
isomerization	isomerise	isomerize
issuance	issue
italianization	italianise	italianize
italicization	italicise	italicize
itchiness	itch
itemization	itemise	itemize
iteration	iterate
itineration	itinerate
jabbing	jab
jabbering	jabber
jacks	jack
jacket	jacket
jackknife	jackknife
jactitation	jactitate
jade	jade
jag	jag
jailing	jail
jamming	jam
jangle	jangle
japan	japan
japery	jape
jarful	jar
jargonization	jargon	jargonise	jargonize
jaundice	jaundice
jaunt	jaunt
jaws	jaw
jawbone	jawbone
jaywalking	jaywalk
jazz	jazz
jeep	jeep
jeering	jeer
jellification	jell	jelly	jellify
jemmy	jemmy
jeopardy	jeopardize
jerkiness	jerk
jester	jest
jets	jet
jettison	jettison
jeweller	jewel
jib	jib
jibe	jibe
jig	jig
jiggle	jiggle
jilt	jilt
jimmies	jimmy
jingle	jingle
jinx	jinx
jitterbug	jitterbug
jive	jive
job	job
jockey	jockey
jogging	jog
joggle	joggle
junction	join
jointer	joint
joker	joke
jollity	jolly
jolt	jolt
justlement	jostle	justle
jotting	jot
jounce	jounce
journalization	journalize	journalise
journeyman	journey
joust	joust
joy	joy
joyride	joyride
jubilation	jubilate
judaization	judaise	judaize
judder	judder
judgeship	judge
jugful	jug
juggling	juggle
jugulation	jugulate
juiciness	juice
jumble	jumble
jump-start	jump-start
jumping	jump
jumpstart	jumpstart
junker	junk
junketing	junket
justification	justify
jutting	jut
juxtaposition	juxtapose
kayak	kayak
kayo	kayo
keel	keel
keenness	keen
keeping	keep
kenning	ken
kennels	kennel
keratinization	keratinise	keratinize
key	key
keyboard	keyboard
keynote	keynote
kibitzer	kibitz
kick-out	kick-out
kicking	kick
kiddie	kid
kidnapping	kidnap
killing	kill
kindling	kindle
kink	kink
kip	kip
kipper	kipper
kissing	kiss
kit	kit
kitten	kitten
kludge	kludge
knackery	knacker
knee	knee
kneecap	kneecap
kneeling	kneel
knell	knell
knife	knife
knight	knight
knitting	knit
knocking	knock
knockout	knockout
knot	knot
knowledge	know
knuckles	knuckle
kotow	kotow
kowtow	kowtow
kyanization	kyanise	kyanize
label	label
labialization	labialise	labialize
laboriousness	labor
labourite	labour
lacing	lace
laceration	lacerate
lack	lack
lacquer	lacquer
lactation	lactate
ladder	ladder
lading	lade	laden
ladleful	ladle
lagging	lag
laicization	laicise	laicize
lam	lam
lamb	lamb
lameness	lame
lamentation	lament
lamination	laminate
lampooner	lampoon
lancers	lance
lancination	lancinate
landman	land
landscapist	landscape
languishment	languish
lapping	lap
lapidation	lapidate
lapidification	lapidify
lapsing	lapse
larder	lard
lark	lark
lashings	lash
lasso	lasso
last	last
latch	latch
lathing	lathe
lather	lather
latinization	latinize
latinisation	latinise
laudation	laud
laughter	laugh
launching	launch
laundering	launder
laureation	laureate
lavation	lave
lavishness	lavish
layman	lay	layer
laze	laze
leaching	leach
leading	lead
leafing	leaf
league	league
leakage	leak
leanness	lean
leaping	leap
leapfrog	leapfrog
learning	learn
lessor	lease
leash	leash
leather	leather
leaving	leave
leavening	leaven
lecherousness	lech
lectureship	lecture
leech	leech
leer	leer
legerity	leg	legate
legalization	legalise	legalize
legislating	legislate
legitimization	legitimate	legitimize
legitimatization	legitimatise	legitimatize
lending	lend
lessening	lessen
letting	let
letterman	letter
levanter	levant
leveller	level
leveraging	lever	leverage
levis	levy
levigation	levigate
levitation	levitate
lying	lie
liaison	liaise
libeler	libel
liberalization	liberate	liberalise	liberalize
libration	librate
licence	licence
licensee	license
licking	lick
liftman	lift
ligature	ligate
enlightenment	light	lighter	enlighten
lightening	lighten
lightning	lightning
lignification	lignify
likelihood	like
likening	liken
lilt	lilt
lime	lime
limitation	limit
limning	limn
limpness	limp
lineation	line
linearity	linearize
lingering	linger
linkman	link
lint	lint
lionization	lionise	lionize
lip-reading	lip-read
lipreading	lipread
lipstick	lipstick
liquation	liquate
liquescence	liquesce
liquidization	liquefy	liquify	liquidate	liquidize
lisper	lisp
listing	list
listening	listen
literalness	literalize
lithographer	lithograph
litigation	litigate
litterer	litter
enlivenment	live	enliven
lixiviation	lixiviate
loading	load
loafing	loaf
loaner	loan
loathsomeness	loath	loathe
lob	lob
lobation	lobate
lobbyist	lobby
locative	locate
localization	localise	localize
lockman	lock
locomotive	locomote
lodgement	lodge
loft	loft
logging	log
logrolling	logroll
loiterer	loiter
loll	loll
lengthening	long	lengthen
looking	look
loom	loom
looper	loop
looseness	loose
loosening	loosen
looting	loot
lope	lope
lordship	lord
losings	lose
lots	lot
lounger	lounge
lousiness	louse
lovely	love
lowness	low
lowering	lower
lubrication	lubricate
lucubration	lucubrate
luff	luff
luggage	lug
luging	luge
lull	lull
lumberman	lumber
luminescence	luminesce
lumper	lump
lunching	lunch
luncheon	luncheon
lunger	lunge
lurcher	lurch
lure	lure
lurker	lurk
lustfulness	lust
luster	luster
lustration	lustrate
lustre	lustre
lutanist	lute
luxation	luxate
luxuriousness	luxuriate
lynching	lynch
lyophilization	lyophilize
lyricality	lyric
lysis	lyse
macadamization	macadamise	macadamize
maceration	macerate
machicolation	machicolate
machination	machine	machinate
macrame	macrame
maculation	maculate
madness	bemadden
madder	madder
madrigal	madrigal
magnetization	magnetise	magnetize
magnification	magnify
mailing	mail
maiming	maim
mainline	mainline
maintenance	maintain
majority	major
making	make
maladministration	maladminister
malcontent	malcontent
malediction	maledict
malfunction	malfunction
maliciousness	malice
malignment	malign
malingering	malinger
mallard	mallard
mallet	mallet
mallow	mallow
maltman	malt
maltreatment	maltreat
mamaguy	mamaguy
manfulness	man
manacle	manacle
manageableness	manage
mandate	mandate
maneuvering	maneuver
mangle	mangle
manicurist	manicure
manifestation	manifest
manifold	manifold
manipulability	manipulate
manoeuvre	manoeuvre
mantle	mantle
manufacturing	manufacture
manumission	manumit
manure	manure
mapping	map
mars	mar
marauding	maraud
marbling	marble
marbleization	marbleize
marching	march
margination	marginate
marination	marinade	marinate
mark-up	mark-up
marking	mark
marketing	market
maroon	maroon
marriageability	marry
marshalship	marshal	marshaling
martyrization	martyr	martyrize
marvelment	marvel
masher	mash
masking	mask
masquerade	masquerade
masses	mass
massacre	massacre
massager	massage
mastership	master
mastermind	mastermind
mastication	masticate
masturbation	masturbate
matting	mat	matt
match	match
matchmaker	matchmake
mating	mate
materialization	materialize
matriculation	matriculate
matter	matter
matureness	mature	maturate
mauler	maul
maximization	maximise	maximize
mayor	may
mazement	maze
meanness	mean
meander	meander
measurability	measure
mechanization	mechanise	mechanize
meddlesomeness	meddle
mediatization	mediate	mediatize	mediatise
medication	medicate
medicine	medicine
meditativeness	meditate
meeting	meet
melanism	melanize
meld	meld
melioration	meliorate
mellowness	mellow
melodiousness	melodize
melting	melt
memorialization	memorise	memorize	memorialise	memorialize
menace	menace
mending	mend
menstruation	menstruate
mention	mention
meow	meow
mercerization	mercerise	mercerize
merchandisement	merchandise
mercurialization	mercurate	mercurialize	mercurialise
mergence	merge
meritoriousness	merit
meshing	mesh
mesmerization	mesmerise	mesmerize
mess	mess
metabolization	metabolize
metallization	metal	metallize
metamorphosis	metamorphose
metastasis	metastasize
meter	meter
methodization	methodise	methodize
methylation	methylate
metrication	metricize
mews	mew
miaou	miaou
miaow	miaow
microfilm	microfilm
microwave	microwave
micturition	micturate
middleman	middle
miff	miff
might	might
migration	migrate
mildew	mildew
militation	militate
militarization	militarise	militarize
milkman	milk
millions	mill
mimer	mime
mimeo	mimeo
mimeograph	mimeograph
mimickry	mimic	mimicker
mincer	mince
mindfulness	mind
minor	mine
mineralization	mineralise	mineralize
mingling	mingle
miniaturization	miniaturise	miniaturize
minification	minify
minimization	minimise	minimize
ministration	minister
minstrel	minstrel
mintage	mint
minuteness	minute
mire	mire
mirror	mirror
misapplication	misapply
misapprehension	misapprehend
misappropriation	misappropriate
misbehavior	misbehave
misbeliever	misbelieve
miscalculation	miscalculate
miscarriage	miscarry
miscegenation	miscegenate
misconception	misconceive
misconduction	misconduct
misconstrual	misconstrue
miscount	miscount
miscreation	miscreate
miscue	miscue
misdating	misdate
misdeal	misdeal
misdirection	misdirect
misdoing	misdo
misdoubt	misdoubt
misfile	misfile
misfire	misfire
misgiving	misgive
misgovernment	misgovern
misguidance	misguide
misinformation	misinform
misinterpretation	misinterpret
misjudgement	misjudge
mismanagement	mismanage
mismatch	mismatch
misplacement	misplace
misplay	misplay
misprint	misprint
misprision	misprise	misprize
mispronunciation	mispronounce
misquotation	misquote
misreading	misread
misreport	misreport
misrepresentation	misrepresent
misrule	misrule
missionary	miss
misspelling	misspell
misstatement	misstate
mister	mist
mistaking	mistake
mistiming	mistime
mistranslation	mistranslate
mistreatment	mistreat
mistrust	mistrust
misunderstanding	misunderstand
misuse	misuse
miter	miter
mitigation	mitigate
mixture	mix
mizzle	mizzle
moaner	moan
mob	mob
mobilization	mobilise	mobilize
mockery	mock
modelling	model
modem	modem
moderateness	moderate
modernization	modernise	modernize
modification	modify
modulation	modulate
moistness	moisturize
moistening	moisten
molding	mold
molestation	molest
mollification	mollify
mollycoddle	mollycoddle
molting	molt
monetization	monetise	monetize
monetarism	monetarize
monger	monger
mongrelization	mongrelise	mongrelize
monitoring	monitor
monkey	monkey
monogram	monogram
monolog	monolog
monologue	monologuize
monopolization	monopolise	monopolize
monument	monumentalize
moo	moo
moocher	mooch
moon	moon
moonlight	moonlight
moonshiner	moonshine
mooring	moor
mopping	mop
mopes	mope	moped
moralization	moralise	moralize
morning	morn
moroccan	moroccanize
morph	morph
mortar	mortar
mortgagor	mortgage
mortice	mortice
mortification	mortify
mortise	mortise
mothball	mothball
mother	mother
motion	motion
motivation	motive	motivate
motley	motley
motorization	motor	motorise	motorize
motorbike	motorbike
motorcycling	motorcycle
mottling	mottle
moulting	mould	moult
mound	mound
mounting	mount
mountaineering	mountaineer
mountebankery	mountebank
mournfulness	mourn
mousing	mouse
mousse	mousse
mouthful	mouth
movement	move
mower	mow
muck	muck
muckraking	muckrake
muddiness	mud	muddy
muddle	muddle
muff	muff
muffler	muffle
mugging	mug
mulch	mulch
mulcting	mulct
mullion	mull
multiplication	multiply
multiplexer	multiplex
multitasking	multitask
mum	mum
mumbling	mumble
mummification	mummify
munching	munch
municipalization	municipalise	municipalize
munitions	munition
murderousness	murder
murk	murk
murmuration	murmur
murther	murther
musculature	muscle
musing	muse
mushroom	mushroom
muss	muss
muster	muster
muteness	mute	mutate
mutilation	mutilate
mutineer	mutiny
muttering	mutter
mutualization	mutualise	mutualize
muzzle	muzzle
mystification	mystify
mythicization	mythicise	mythicize
mythologization	mythologise	mythologize
nag	nag
nail	nail
naming	name
nap	nap
narcotization	narcotise	narcotize
nark	nark
narrative	narrate
narrowness	narrow
nasalization	nasale	nasalise	nasalize
nationalization	nationalise	nationalize
natter	natter
naturalization	naturalise	naturalize
nauseation	nauseate
navigability	navigate
nearness	near
nebulization	nebulise	nebulize
necessitation	necessitate
necking	neck
necropsy	necropsy
necrosis	necrose
need	need
needle	needle
negation	negate
negativeness	negative
neglectfulness	neglect
negotiability	negotiate
neigh	neigh
neighbor	neighbor
neighbour	neighbour
nerves	nerve
nestor	nest
nestling	nestle
netting	net
nettle	nettle
network	network
neutering	neuter
neutralization	neutralise	neutralize
nibbling	nibble
nick	nick
nickel	nickel
nickname	nickname
nictitation	nictate	nictitate
nidification	nidify	nidificate
niello	niello
nip	nip
nitration	nitrate
nitrification	nitrify
nitrogenization	nitrogenize
nix	nix
nod	nod
noisiness	noise
nominative	nominate
nonplus	nonplus
nonsuit	nonsuit
noose	noose
normalization	normalise	normalize
normanization	normanise	normanize
nosiness	nose
nosh	nosh
notarization	notarize
notch	notch
notation	note	notate
noticeableness	notice
notification	notify
nourishment	nourish
novelization	novelize
nuance	nuance
nucleation	nucleate
nudge	nudge
nuke	nuke
nullification	nullify
numbness	numb
numbering	number
numerousness	numerate
nursing	nurse
nurturing	nurture
nutation	nut	nutate
oar	oar
obelization	obelize
obedience	obey
obfucscation	obfuscate
objectionableness	object
objectification	objectify
objurgation	objurgate
obligation	oblige	obligate
obliteration	obliterate
obscureness	obscure
obsecration	obsecrate
observatory	observe
obsessiveness	obsess
obsolescence	obsolesce
obstruction	obstruct
obtainment	obtain
obtestation	obtest
obtrusiveness	obtrude
obturation	obturate
obversion	obvert
obviation	obviate
occasionment	occasion
occidentalization	occidentalise	occidentalize
occlusive	occlude
occultation	occult
occupation	occupy
occurence	occur
odor	odorize
offing	of
offensiveness	offend
offering	offer
officiousness	officer	officiate	officialize
offset	offset
ogler	ogle
oilman	oil
ok	ok
okay	okay
omen	omen
omission	omit
omnibus	omnibus
omnipresence	omnipresent
oozing	ooze
opalescence	opalesce
optative	ope	opt
openness	open
operability	operate
opinion	opine
oppilation	oppilate
oppositeness	oppose
oppressiveness	oppress
opsonification	opsonize
optimization	optimise	optimize
oration	orate
orb	orb
orbit	orbit
orchestration	orchestrate
ordination	ordain
ordering	order
organization	organize
organisation	organise
orientalization	orient	orientate	orientalise	orientalize
origination	originate
ornamentation	ornament
orphanage	orphan
oscillation	oscillate
osculation	osculate
osmosis	osmose
ossification	ossify
ostracization	ostracize
ousting	oust
outing	out
outbalance	outbalance
outbreeding	outbreed
outcropping	outcrop
outcross	outcross
outcry	outcry
outfitting	outfit
outgo	outgo
outgrowth	outgrow
outlaw	outlaw
outlay	outlay
outline	outline
outpouring	outpour
output	output
outrageousness	outrage
outreach	outreach
outrider	outride
outshoot	outshoot
outspan	outspan
outspread	outspread
outwardness	outward
overactivity	overact
overawe	overawe
overbid	overbid
overbook	overbook
overburden	overburden
overcall	overcall
overcapitalization	overcapitalise	overcapitalize
overcasting	overcast
overcharge	overcharge
overclothes	overclothe
overcompensation	overcompensate
overdevelopment	overdevelop
overdraft	overdraw
overdrive	overdrive
overestimation	overestimate
overexertion	overexert
overexposure	overexpose
overflowing	overflow
overgrowth	overgrow
overhang	overhang
overhauling	overhaul
overhead	overhead
overindulgence	overindulge
overjoy	overjoy
overlapping	overlap
overlayer	overlay
overload	overload
overlook	overlook
overnighter	overnight
overpayment	overpay
overprint	overprint
overprotection	overprotect
overrating	overrate
override	override
overrun	overrun
overseer	oversee
overshoot	overshoot
oversimplification	oversimplify
overstatement	overstate
overstrain	overstrain
oversubscription	oversubscribe
oversupply	oversupply
overtaking	overtake
overthrow	overthrow
overturning	overturn
overuse	overuse
overvaluation	overvalue
overweight	overweight
overworking	overwork
oviposition	oviposit
ovulation	ovulate
owner	own
oxidization	oxidate	oxidise	oxidize
oxygenation	oxygenate	oxygenize
oyster	oyster
ozonization	ozonise	ozonize
pacing	pace
pacification	pacify
packaging	pack	package
padding	pad
paddler	paddle
padlock	padlock
paganization	paganise	paganize
pagination	page	paginate
painfulness	pain
painting	paint
pairing	pair
pal	pal
palatalization	palatalise	palatalize
palaver	palaver
paleness	pale
palisade	palisade
pallor	pall
palliation	palliate
palmist	palm
palpation	palpate
palpitation	palpitate
palsy	palsy
paltering	palter
pampering	pamper
panful	pan
pancake	pancake
panderer	pander
panelling	panel
panhandler	panhandle
panic	panic
panting	pant
pantomimer	pantomime
pantry	pantry
papering	paper
par	par
parabolization	parabolize	parabolise
parachutist	parachute
parader	parade	paradize
paragrapher	paragraph
parallelism	parallel	parallelize
paralyzation	paralyse	paralyze
parapet	parapet
paraphrase	paraphrase
parasitization	parasitize
parcelling	parcel
parchment	parch
pardoner	pardon
parentage	pare	parent
parenthesization	parenthesize
pargeting	parget
parking	park
parlay	parlay
parley	parley
parodist	parody
parolee	parole
parquet	parquet
parrot	parrot
parry	parry
parsee	parse
partitioning	part	partition
partaker	partake
party	party
participation	participate
particularization	particularise	particularize
partnership	partner
passionateness	pass
passage	passages
pastorate	paste
pasteurization	pasteurize
pasteurisation	pasteurise
pasture	pasture
patness	pat
patching	patch
patentee	patent
patrolling	patrol
patronization	patronage	patronise	patronize
patter	patter
pattern	pattern
pauperization	pauper	pauperize
pause	pause
pavement	pave
pavilion	pavilion
paw	paw
pawning	pawn
payment	pay
peach	peach
peak	peak
pealing	peal
pearlite	pearl
pecker	peck
pectization	pectise	pectize
peculation	peculate
pedaller	pedal
peddling	peddle
pedicure	pedicure
peeing	pee
peek	peek
peeler	peel
peeper	peep
peer	peer
peeve	peeve
peg	peg
pelting	pelt
penning	pen	penance
penalization	penalise	penalize
pencil	pencil
penetrability	penetrate
penny-pinching	penny-pinch
pensioner	pension
people	people
pep	pep
pepper	pepper
peptization	peptise	peptize
peptonization	peptonise	peptonize
perambulation	perambulate
perceptiveness	perceive
perch	perch
percolation	percolate
percussion	percuss
peregrination	peregrinate
perennation	perennate
perfectibility	perfect
perforation	perforate
performance	perform
perfumery	perfume
perfusion	perfuse
perilousness	peril
perishables	perish
perjurer	perjure
perk	perk
perlocutionary	perm
permeableness	permeate
permissiveness	permit
permutableness	permute
peroration	perorate
peroxide	peroxide
perpetration	perpetrate
perpetuation	perpetuate
perplexity	perplex
persecution	persecute
perseveration	persevere
persistency	persist
personalization	personate	personalise	personalize
personification	personify
perspiration	perspire
persuasiveness	persuade
pertinacity	pertain
perturbation	perturb	perturbate
perusing	peruse
pervasiveness	pervade
perverseness	pervert
pesterer	pester
pestle	pestle
petting	pet
peter	peter
petitioner	petition
petrification	petrify
phase	phase
philosophization	philosophise	philosophize
phlebotomization	phlebotomize
phonation	phonate
phoner	phone
phosphatization	phosphatise	phosphatize
phosphorescence	phosphoresce
photo	photo
photocomposition	photocompose
photocopier	photocopy
photographer	photograph
photosensitization	photosensitise	photosensitize
photostat	photostat
photosynthesis	photosynthesize
phrasing	phrase
physicalness	physic
picking	pick
picket	picket
pickle	pickle
picnicker	picnic
picturing	picture
piddle	piddle
piece	piece
pierce	pierce
piffle	piffle
pigmentation	pig	pigment
pigeonholing	pigeonhole
pike	pike
piling	pile
pilferage	pilfer
pilgrimage	pilgrimage
pillaging	pillage
pillory	pillory
pillow	pillow
piloting	pilot
pimp	pimp
pinning	pin
pinche	pinch
pining	pine
ping	ping
pinion	pinion
pink	pink
pinnacle	pinnacle
pinpoint	pinpoint
pioneer	pioneer
pip	pip
pipeful	pipe
piquancy	pique
pirate	pirate
pirouette	pirouette
pissing	piss
pitting	pit
pitcherful	pitch
pitchfork	pitchfork
pith	pith
pitter-patter	pitter-patter
pity	pity
pivot	pivot
placard	placard
placation	placate
place-kicking	place-kick
placement	place
plagiarization	plagiarise	plagiarize
plague	plague
plainness	plain
plait	plait
planning	plan
planeness	plane
planking	plank
plantation	plant
plash	plash
plasmolysis	plasmolyze
plastering	plaster
plasticization	plasticise	plasticize
plateful	plate
platinization	platinise	platinize
platitudinization	platitudinize
playing	play
playaction	playact
playback	playback
pleading	plead
pleasantness	please	pleasure
pleating	pleat
pledge	pledge
plenishment	plenish
plight	plight
plodding	plod
plodge	plodge
plonk	plonk
plop	plop
plot	plot
ploughman	plough
plowing	plow
pluck	pluck
plug	plug
plumbism	plumb
plumage	plume
plummet	plummet
plumpness	plump
plundering	plunder
plunger	plunge
plunk	plunk
pluralization	pluralise	pluralize
pliantness	ply
poaching	poach
pock	pock
pocketful	pocket
pockmark	pockmark
pod	pod
podzolization	podzolize
poeticization	poeticize
poetization	poetize
pointing	point
poise	poise
poisoning	poison
poking	poke
polarization	pole	polarise	polarize
poleaxe	poleax	poleaxe
polemic	polemize
policeman	police
polishing	polish
politicization	politicize
polka	polka
polls	poll
pollard	pollard
pollination	pollenate	pollinate
pollution	pollute
polymerization	polymerise	polymerize
polytick	polytick
pomade	pomade
pommel	pommel
pompadour	pompadour
ponderousness	ponder
pongee	pong
poniard	poniard
pontification	pontificate
pooch	pooch
pool	pool
popping	pop
popularization	popularise	popularize
population	populate
porosity	pore
portion	port	portion	portend
portage	portage
portraying	portray
positiveness	pose	posit	position
possessiveness	possess
posterity	post	poster
postage	postage
postfix	postfix
postmark	postmark
postmaster	postmaster
postponement	postpone
postscript	postscript
postulation	postulate
posturing	posture
potation	pot
potentiation	potentiate
pother	pother
potterer	potter
pouch	pouch
poultice	poultice
pounce	pounce
pounding	pound
pouring	pour
pout	pout
powder	powder	powderize
powerfulness	power
powwow	powwow
practicableness	practice	practise
prayer	pray
praise	praise
prancer	prance
prank	prank
prate	prate
prattler	prattle
prawn	prawn
preachment	preach
preachification	preachify
preamble	preamble
prearrangement	prearrange
precancellation	precancel
precaution	precaution
precedency	precede
precession	precess
precipitousness	precipitate
preciseness	precis
preclusion	preclude
preconception	preconceive
precondition	precondition
preconization	preconise	preconize
predecease	predecease
predestination	predestine	predestinate
predetermination	predetermine
predication	predicate
predictability	predict
predigestion	predigest
predisposition	predispose
predomination	predominate
preemption	preempt
preexistence	preexist
prefabrication	prefabricate
preface	preface
preferability	prefer
prefigurement	prefigure
prefixture	prefix
prejudgement	prejudge
prejudice	prejudice
prelection	prelect
prelusion	prelude
premeditation	premeditate
premiership	premier	premiere
premises	premise
premiss	premiss
premonition	premonish
preoccupation	preoccupy
preordination	preordain
preparative	prepare
prepayment	prepay
preponderation	preponderate
preposition	preposition
prepossession	prepossess
presage	presage
prescription	prescribe	prescript
presentation	present
preservative	preserve
presidency	preside
presignification	presignify
pressurization	press	pressure	pressurise	pressurize
prestidigitation	prestidigitate
presumptuousness	presume
presupposition	presuppose
pretension	pretend	pretense
pretermission	pretermit
prettification	prettify
prevalence	prevail
prevarication	prevaricate
preventative	prevent
preview	preview
prevision	previse
predation	prey	predate
pricing	price
pricking	prick
prickling	prickle
pridefulness	pride
primness	prim	prime
primping	primp
printing	print
privateness	privatize
privilege	privilege
prize	prize
prizefighter	prizefight
probation	probate
probing	probe
processional	proceed	process
proclamation	proclaim
procrastination	procrastinate
procreation	procreate
proctor	proctor
procurement	procure
prodding	prod
productiveness	produce
profaneness	profane
professionalism	profess
profferment	proffer
profile	profile
profitableness	profit	profiteer
profoundness	profound
profuseness	profuse
prognostication	prognosticate
programming	program
programmer	programme
progressiveness	progress
prohibition	prohibit
projection	project
prolapse	prolapse
proliferation	proliferate
prolog	prologize
prolongation	prolong	prolongate
promenade	promenade
promisor	promise
promotion	promote
promptness	prompt
promulgation	promulgate
pronation	pronate
prong	prong
pronominalization	pronominalise	pronominalize
pronunciation	pronounce
provenance	proof	prove
proofreader	proofread
propman	prop
propagandization	propagandize
propagation	propagate
propulsion	propel	propell
propitiousness	propitiate
proportionateness	proportion	proportionate
proposer	propose
proposition	proposition
propound	propound
proration	prorate
prorogation	prorogue
proscription	proscribe
prosecution	prosecute
proselytization	proselyte	proselytise	proselytize
prospector	prospect
prosperity	prosper
prostatitis	prostate
prostitution	prostitute
prostration	prostrate
protectiveness	protect
prototype	prototype
protraction	protract
protrusion	protrude
provisioner	provide	provision
provocative	provoke
prowler	prowl
pruning	prune
prussianization	prussianise	prussianize
prying	pry
psyche	psych
psychoanalysis	psychoanalyze
psychologization	psychologize
publicization	publish	publicise	publicize
pucker	pucker
puddler	puddle
puffer	puff
pug	pug
puking	puke
pulling	pull
pullulation	pullulate
pulp	pulp
pulsation	pulse	pulsate
pulverization	pulverise	pulverize
pumps	pump
punning	pun
puncher	punch
punctuation	punctuate
puncturing	puncture
punishment	punish
punting	punt
pup	pup
pupation	pupate
purchasing	purchase
pureness	puree
purgatory	purge
purification	purify
purl	purl
purloinment	purloin
purpleness	purple
purport	purport
purposefulness	purpose
purr	purr
purser	purse
pursuance	pursue
purveyance	purvey
pushing	push
pustulation	pustulate
putting	put
putrefaction	putrefy
putterer	putt	putter
putty	putty
puzzlement	puzzle
pyramid	pyramid
quackery	quack
quadrisection	quadrisect
quadruplication	quadruple	quadruplicate
quail	quail
quakerism	quake
qualification	qualify
quantifiability	quantify
quantization	quantise	quantize
quarantine	quarantine
quarrelsomeness	quarrel
quarryman	quarry
quartering	quarter
quarterback	quarterback
quaver	quaver
queens	queen
queerness	queer
quelling	quell
quenching	quench
query	query
quest	quest
questioning	question
queue	queue
quibbler	quibble
quickening	quicken
quickstep	quickstep
quietness	quiet
quilting	quilt
quintuplication	quintuple	quintuplicate
quip	quip
quirk	quirk
quitclaim	quitclaim
quivering	quiver
quizzer	quiz	quizzes
quotation	quote
rabbet	rabbet
rabbit	rabbit
racist	race
rack	rack
racketeering	racket	racketeer
radiation	radiate
radio	radio
radioactivation	radioactivate
raffle	raffle
raftman	raft	rafter
rag	rag
ragee	rage
raider	raid
railing	rail
railroader	railroad
raiment	raiment
rain	rain
raising	raise
rake	rake
rallying	rally
ramman	ram
rambler	ramble
ramification	ramify
ramp	ramp
rampage	rampage
ranching	ranch
randomization	randomise	randomize
ranger	range
rankness	rank
ransacking	ransack
ransom	ransom
ranting	rant
rap	rap
rapist	rape
rapture	rapture
rarefication	rarefy
rasping	rasp
ratting	rat
ratchet	ratchet
rating	rate
ratification	ratify
ratiocination	ratiocinate
rationalization	ration	rationalise	rationalize
rattling	rattle
ravagement	ravage
raving	rave
ravelling	ravel
ravenousness	raven
ravishment	ravish
ray	ray
razing	raze	razor
razzing	razz
re-afforestation	re-afforest
re-creation	re-create
re-exportation	re-export
reaching	reach
reactionism	react
reactivation	reactivate
reading	read
readjustment	readjust
readiness	ready
reafforestation	reafforest
realization	realise	realize
reallocation	reallocate
ream	ream
reaper	reap
reappearance	reappear
reapportioning	reapportion
rearing	rear
rearmament	rearm
rearrangement	rearrange
reasonableness	reason
reassembly	reassemble
reassessment	reassess
reassignment	reassign
reassurance	reassure
rebate	rebate
rebellion	rebel
rebound	rebound
rebuff	rebuff
rebuilding	rebuild
rebuke	rebuke
rebutter	rebut
recall	recall
recantation	recant
recapitulation	recap	recapitulate
recapitalization	recapitalize
recapture	recapture
recasting	recast
recce	recce
recessional	recede	recess
receptiveness	receipt	receive
recidivism	recidivate
reciprocation	reciprocate
recitative	recite
reckoning	reckon
reclamation	reclaim
reclination	recline
recognizance	recognise	recognize
recoil	recoil
recollection	recollect
recombinant	recombine
recommendation	recommend
recommitment	recommit
recompence	recompence
recompensation	recompense
recomposition	recompose
reconciliation	reconcile
reconditeness	recondition
reconnoitering	reconnoiter	reconnoitre
reconsideration	reconsider
reconstitution	reconstitute
reconstruction	reconstruct
reconversion	reconvert
recordation	record
recounting	recount
recoupment	recoup
recoverer	recover
recreation	recreate
recrimination	recriminate
recrudescence	recrudesce
recruitment	recruit
recrystallization	recrystallise	recrystallize
rectification	rectify
recuperation	recuperate
recurrence	recur	recurse
recusation	recuse
recycling	recycle
redaction	redact
rededication	rededicate
redemption	redeem
redeliverance	redeliver
redeployment	redeploy
redevelopment	redevelop
redintegration	redintegrate
redirection	redirect
redistribution	redistribute
redouble	redouble
redress	redress
reduction	reduce
reduplication	reduplicate
reeducation	reeducate
reefer	reef
reek	reek
reel	reel
reelection	reelect
reenforcement	reenforce
reevaluation	reevaluate
reeve	reeve
reexamination	reexamine
refectory	refect
reference	refer	reference
refereeing	referee
refilling	refill
refinement	refine	refinance
refinisher	refinish
refitment	refit
reflation	reflate
reflectivity	reflect
reflexiveness	reflex
reflux	reflux
reforestation	reforest
reformatory	reform
refractiveness	refract
refrainment	refrain
refreshment	refresh
refrigeration	refrigerate
refueling	refuel
refuge	refuge
refund	refund
refurbishment	refurbish
refusal	refuse
refutation	refute
regaining	regain
regalement	regale
regards	regard
regelation	regelate
regeneration	regenerate
regimentation	regiment
region	regionalize
registration	register	registrate
regression	regress
regrets	regret
regularization	regularise	regularize
regulating	regulate
regurgitation	regurgitate
rehabilitation	rehabilitate
rehash	rehash
rehearing	rehear
rehearsal	rehearse
reification	reify
reign	reign
reillumination	reilluminate
reimbursement	reimburse
reimportation	reimport
reins	rein
reincarnation	reincarnate
reinforcement	reinforce
reinstatement	reinstate
reinsurance	reinsure
reinterpretation	reinterpret
reinvestment	reinvest
reissue	reissue
reiteration	reiterate
rejection	reject
rejoicing	rejoice
rejuvenation	rejuvenate	rejuvenesce
relapsing	relapse
relativity	relate
relativism	relativize
relaxation	relax
relays	relay
release	release
relegation	relegate
relentlessness	relent
reliever	relieve
relinquishment	relinquish
relishing	relish
reliving	relive
relocation	relocate
reluctivity	reluct
relumination	relumine
reliance	rely	relie
remanence	remain	remainder
remaking	remake
remandment	remand
remark	remark
rematch	rematch
remediation	remedy
remembrance	remember
remilitarization	remilitarize
reminder	remind
reminiscence	reminisce
remittence	remit
remonetization	remonetise	remonetize
remonstration	remonstrate
remount	remount
remover	remove
remuneration	remunerate
rencounter	rencounter
renting	rend	rent
rendition	render
rendezvous	rendezvous
renegade	renegade
renege	renege
renegotiation	renegotiate
renewal	renew	renewal
renunciation	renounce	renunciate
renovation	renovate
renown	renown
reordering	reorder
reorganization	reorganize
reorientation	reorient	reorientate
reparation	repair
repartition	repartition
repast	repast
repatriation	repatriate
repayment	repay
repeal	repeal
repetitiousness	repeat	repetition
repulsiveness	repel	repulse
repentance	repent
rephrasing	rephrase
replaceability	replace
replay	replay
replenishment	replenish
repletion	replete
replication	replicate
reply	reply
reporting	report
reposal	repose
repositioning	reposit	reposition
repossession	repossess
reprehensibility	reprehend
representative	represent
repression	repress
reprievement	reprieve
reprimand	reprimand
reprinting	reprint
reprisal	reprise
reproachment	reproach
reprobation	reprobate
reproducibility	reproduce
reproof	reproof
reproval	reprove
republication	republish
republicanization	republicanise	republicanize
repudiation	repudiate
repugnancy	repugn
reputability	repute
request	request
requisiteness	require	requisition
requitement	requite
rerun	rerun
rescindment	rescind
rescuer	rescue
researcher	research
resection	resect
resemblance	resemble
resentment	resent
reservation	reserve
reset	reset
resettlement	resettle
reshuffling	reshuffle
residency	reside
resignation	resign
resiliency	resile
resination	resin	resinate
resistivity	resist
resoluteness	resolve
resonation	resonate
resorption	resorb
resort	resort
respectfulness	respect
respiration	respire	respirate
respite	respite
responsibleness	respond
restfulness	rest
restatement	restate
restitution	restitute
restorative	restore
restraint	restrain
restrictiveness	restrict
resultant	result
resumption	resume
resurgence	resurge
resurrection	resurrect
resuscitation	resuscitate
retailing	retail
retentiveness	retain
retaking	retake
retaliation	retaliate
retardation	retard
rethink	rethink
reticulation	reticulate
retirement	retire
retortion	retort
retracement	retrace
retraction	retract
retread	retread
retreatant	retreat
retrenchment	retrench
retriever	retrieve
retroaction	retroact
retrocession	retrocede
retrogradation	retrograde
retrogression	retrogress
retrospective	retrospect
return	return
reunification	reunify
reunion	reunite
rev	rev
revalorization	revalorise	revalorize
revaluation	revalue	revaluate
revamping	revamp
revegetation	revegetate
revelation	revel	reveal
revenge	revenge
reverberation	reverberate
reverence	revere	reverence
reversibility	revert	reverse
revetement	revet
reviewer	review
revilement	revile
revision	revise
revitalization	revitalise	revitalize
revivalism	revive
revivification	revivify
revocability	revoke
revolutionary	revolt	revolve
revolutionization	revolutionize
reward	reward
rewind	rewind
rewording	reword
rewriting	rewrite
rhapsodization	rhapsodise	rhapsodize
rhumba	rhumba
rhyme	rhyme
ribbing	rib
rick	rick
rickshaw	rickshaw
ricochet	ricochet
riddance	rid
riddle	riddle
riding	ride
ridge	ridge
ridiculousness	ridicule
riff	riff
riffle	riffle
rifleman	rifle
rigorousness	rig
rightfulness	right
rigidification	rigidify
rim	rim
rime	rime
rind	rind
ringing	ring
rinsing	rinse
rioting	riot
rip	rip
ripening	ripen
riposte	riposte
rippling	ripple
rising	rise
risking	risk
rissole	rissole
ritualization	ritualize
rivalry	rival
river	rive
riveter	rivet
roamer	roam
roaring	roar
roasting	roast
robbery	rob
robe	robe
rocker	rock
rocketry	rocket
roentgenization	roentgenise	roentgenize
roisterer	roister
roleplaying	roleplay
rolling	roll
romanization	romanise	romanize
romantic	romance
romanticization	romanticise	romanticize
romper	romp
roneo	roneo
roofing	roof
rook	rook
roomful	room
rooster	roost
rooting	root
roping	rope
roquet	roquet
rosin	rosin
rottenness	rot
rotation	rotate
rouge	rouge
roughness	rough
roughcast	roughcast
roundness	round
rousing	rouse
route	rout	route
routinization	routinize
roving	rove
rowing	row
rubbing	rub
rubberization	rubber	rubberize
rubberneck	rubberneck
rubbish	rubbish
rubification	rubefy
rubrication	rubric	rubricate
ruck	ruck
ruddles	ruddle
rue	rue
ruff	ruff
ruffle	ruffle
ruggedization	ruggedize
ruination	ruin	ruinate
ruling	rule
rumba	rumba
rumbling	rumble
rumination	ruminate
rummage	rummage
rumor	rumor
rumour	rumour
rumpus	rumpus
runniness	run
rupture	rupture
ruralization	ruralise	ruralize
rushing	rush
russianization	russianise	russianize
rusting	rust
rustication	rusticate
rustling	rustle
rut	rut
saber	saber
sabotage	sabotage
sabre	sabre
saccharification	saccharify
sacking	sack
sacrifice	sacrifice
sadness	sad
saddler	saddle
safari	safari
safeguard	safeguard
sag	sag
sailing	sail
sailplaning	sailplane
saint	saint
salaam	salaam
salability	sell
salification	salify
salinity	salinate
salivation	salivate
sallowness	sallow
sally	sally
salting	salt
salutation	salute
salvager	salvage
salvation	salve
samba	samba
sampling	sample
sanctification	sanctify
sanction	sanction
sand-casting	sand-cast
sander	sand
sandbag	sandbag
sandblaster	sandblast
sandpaper	sandpaper
sandwichman	sandwich
sanitization	sanitate	sanitise	sanitize
sap	sap
saponification	saponify
sashay	sashay
sassing	sass
satellite	satellite
satiation	satiate
satirization	satirise	satirize
satisfaction	satisfy
saturation	saturate
saucer	sauce
saunterer	saunter
sauteing	saute
savageness	savage
savoring	save	savor
savour	savour
savvy	savvy
sawyer	saw
saying	say
scab	scab
scald	scald
scaling	scale
scallop	scallop
scalp	scalp
scamp	scamp
scamper	scamper
scanning	scan
scandalousness	scandalise	scandalize
scantness	scant
scar	scar
scare	scare
scarf	scarf
scarification	scarify
scarp	scarp
scarper	scarper
scat	scat
scathe	scathe
scattering	scatter
scavenger	scavenge
scend	scend
scent	scent
scepter	scepter
scheduling	schedule
schematization	schematize	schematise
schemer	scheme
schmooze	schmooze
schoolman	school
scintillation	scintillate
scissors	scissor
scoffer	scoff
scolding	scold
scollop	scollop
sconce	sconce
scooping	scoop
scooter	scoot
scorcher	scorch
scores	score
scorification	scorify
scorn	scorn
scotchman	scotch
scouring	scour
scourge	scourge
scouting	scout
scowl	scowl
scrabble	scrabble
scrag	scrag
scrambler	scramble
scraping	scrap	scrape
scratching	scratch
scrawl	scrawl
screaming	scream
screeching	screech
screening	screen
screwing	screw
scribbler	scribble
scriber	scribe
scrimmage	scrimmage
scrimshanker	scrimshank
script	script
scroll	scroll
scrounger	scrounge
scrubbing	scrub
scrummage	scrummage
scrunch	scrunch
scrupulousness	scruple
scrutineer	scrutinise	scrutinize
scudding	scud
scuffs	scuff
scuffle	scuffle
scullion	scull
sculpturer	sculpt	sculpture
scupper	scupper
scurry	scurry
scuttle	scuttle
scythe	scythe
sealing	seal
seamstress	seam
seaplane	seaplane
searching	search
seasonableness	season
seating	seat
secession	secede
secernment	secern	secernate
seclusion	seclude
secondment	second
secretiveness	secrete
sectionalization	section	sectionalise	sectionalize
secularization	secularise	secularize
secureness	secure
sedateness	sedate
sedimentation	sediment
seduction	seduce
sighting	see	sight
seedman	seed
seeking	seek
seepage	seep
seesaw	seesaw
seethe	seethe
segmentation	segment
segregation	segregate
seine	seine
seizure	seise	seize
selectivity	select
semaphore	semaphore
sending	send
sensitization	sense	sensitise	sensitize
sensualization	sensualize
sentence	sentence
sentimentalization	sentimentalise	sentimentalize
separateness	separate
sequence	sequence
sequestration	sequester	sequestrate
sequin	sequin
serenade	serenade
serialization	serialise	serialize
seriation	seriate
sermonization	sermonize
serration	serrate
serviceableness	serve	service
setting	set
settlement	settle
severeness	sever	severalize
sewerage	sew
sexist	sex
sextuplication	sextuplicate
shack	shack
shackle	shackle
shadiness	shade
shadow-boxing	shadow-box
shadowing	shadow
shadowboxing	shadowbox
shaft	shaft
shagging	shag
shakiness	shake
shallowness	shallow
sham	sham
shamanism	shamanize
shambling	shamble
shamefulness	shame
shampoo	shampoo
shanghaier	shanghai
shank	shank
shaping	shape
sharing	share
shark	shark
sharpener	sharpen
sharpshooter	sharpshoot
shattering	shatter
shaving	shave
shawl	shawl
shearing	shear
sheathing	sheathe
shedding	shed
sheeting	sheet
shelving	shelve
shelling	shell
shellac	shellac
shelter	shelter
shepherd	shepherd
sherardization	sherardise	sherardize
shielding	shield
shifting	shift
shilling	shill
shillyshally	shillyshally
shimmer	shimmer
shimmy	shimmy
shin	shin
shininess	shine
shingling	shingle
shipping	ship
shipwreck	shipwreck
shirking	shirk
shirting	shirt
shitting	shit
shivering	shiver
shocker	shock
shoes	shoe	shoal
shoehorn	shoehorn
shopping	shop
shoplifting	shoplift
shoring	shore
shortness	short
shortening	shorten
shooting	shoot
shoulder	shoulder
shouting	shout
shove	shove
shovelful	shovel
showiness	show
shower	shower
shred	shred
shrieking	shriek
shrift	shrive
shrillness	shrill
shrimp	shrimp
shrine	shrine
shrinking	shrink
shroud	shroud
shrug	shrug
shucks	shuck
shudder	shudder
shuffling	shuffle
shunning	shun
shunter	shunt
shutting	shut
shutter	shutter
shuttle	shuttle
shuttlecock	shuttlecock
shyness	shy
sibilation	sibilate
sickness	sick
siding	side
sideslip	sideslip
sidestep	sidestep
sidetrack	sidetrack
sidle	sidle
siege	siege
sieve	sieve
sifting	sift
sigh	sigh
sightseeing	sightsee
signalization	sign	signal	signalize
signification	signify
signpost	signpost
silencer	silence
silhouette	silhouette
silicification	silicify
silt	silt
silver	silver
simmering	simmer
simper	simper
simplification	simplify
simulation	simulate
simulcast	simulcast
sinfulness	sin
singing	sing	singe
single-foot	single-foot
singleness	single
singsong	singsong
singularization	singularise	singularize
sinking	sink
sinter	sinter
sinuation	sinuate
sipping	sip
siphon	siphon
sire	sire
sitting	sit
site	site
situation	situate
sizing	size
skating	skate
skateboarding	skateboard
skeletonization	skeletonise	skeletonize
sketcher	sketch
skewness	skew
skewer	skewer
skiing	ski
skid	skid
skimming	skim
skinful	skin
skip	skip
skipper	skipper
skirl	skirl
skirmisher	skirmish
skirt	skirt
skittles	skittle
skivvies	skivvy
skulking	skulk
skunk	skunk
sky	sky
skylark	skylark
skyrocket	skyrocket
slackness	slack
slackening	slacken
slalom	slalom
slam	slam
slanderer	slander
slang	slang
slant	slant
slap	slap
slashing	slash
slat	slat
slating	slate
slaughterer	slaughter
slavery	slave
slaver	slaver
slaying	slay
sledding	sled
sledge	sledge
sledgehammer	sledgehammer
sleekness	sleek
sleeping	sleep
sleepwalking	sleepwalk
sleet	sleet
sleigh	sleigh
slenderization	slenderize
slews	slew
slicing	slice
slickness	slick
slider	slide
slightness	slight
slimness	slim
sliminess	slime
slinging	sling
slipperiness	slip
slipcover	slipcover
slit	slit
sliver	sliver
slobber	slobber
sloganeering	sloganeer
slops	slop
slope	slope
slot	slot
slouch	slouch
sloughing	slough
slowness	slow
slug	slug
sluice	sluice
slum	slum
slumberer	slumber
slump	slump
slur	slur
slurp	slurp
slush	slush
smacking	smack
smartness	smart
smashing	smash
smattering	smatter
smear	smear
smelling	smell
smelter	smelt
smiling	smile
smirch	smirch
smirk	smirk
smoking	smoke
smolder	smolder
smooching	smooch
smoothness	smooth
smother	smother
smoulder	smoulder
smudge	smudge
smuggling	smuggle
smut	smut
snack	snack
snaffle	snaffle
snafu	snafu
snag	snag
snail	snail
snake	snake
snap	snap
snare	snare
snarl	snarl
snatcher	snatch
sneakiness	sneak
sneering	sneer
sneezing	sneeze
snick	snick
snicker	snicker
sniff	sniff
sniffle	sniffle
snigger	snigger
snipping	snip
sniper	snipe
snitch	snitch
sniveling	snivel
snogging	snog
snooker	snooker
snoopiness	snoop
snooze	snooze
snoring	snore
snorkeling	snorkel
snorting	snort
snowman	snow
snowball	snowball
snowmobile	snowmobile
snub	snub
snuffers	snuff
snuffle	snuffle
snuggling	snuggle
soaking	soak
soap	soap
soaring	soar
sobbing	sob
soberness	sober
socialization	socialise	socialize
sock	sock
sod	sod
sodom	sodomize
softening	soften
soiling	soil
sojourner	sojourn
solacement	solace
solarization	solarise	solarize
soldering	solder
soldiership	soldier
sole	sole
solemnization	solemnise	solemnize
solemnification	solemnify
solicitousness	solicit
solidification	solidify
soliloquization	soliloquize
solmization	solmizate
soloist	solo
solubilization	solubilize
solvation	solve	solvate
somersaulting	somersault
somnambulation	somnambulate
sonneteer	sonnet
soot	soot
sooth	soothe
soothsaying	soothsay
sops	sop
sophistication	sophisticate
sorption	sorb
sorceress	sorcerize
sorrowfulness	sorrow
sorting	sort
soundness	sound
soup	soup
sourness	sour
sousing	souse
sovietization	sovietise	sovietize
sower	sow
spatiality	space
spadeful	spade
span	span
spangle	spangle
spanking	spank
sparring	spar
spareness	spare
spark	spark
sparkling	sparkle
spats	spat
spatchcock	spatchcock
spattering	spatter
spawn	spawn
spaying	spay
speaking	speak
spear	spear
spearhead	spearhead
specialization	specialise	specialize
specification	specify
speck	speck
speckle	speckle
spectator	spectate
speculativeness	speculate
speechification	speechify
speeding	speed
spelling	spell
spellbinder	spellbind
spelunker	spelunk
spending	spend
sphacele	sphacelate
spiciness	spice
spiel	spiel
spike	spike
spillage	spill
spinning	spin
spindle	spindle
spiral	spiral
spiritualization	spirit	spiritize	spiritualize	spiritualise
spirt	spirt
spitting	spit
spitefulness	spite
splashing	splash
splat	splat
splattering	splatter
splay	splay
splicing	splice
splint	splint
splintering	splinter
split-up	split-up
split	split
splotch	splotch
splurge	splurge
splutter	splutter
spoilation	spoil
spoliation	spoliate
sponge-down	sponge-down
sponginess	sponge
sponsorship	sponsor
spoof	spoof
spook	spook
spool	spool
spoonful	spoon
sports	sport
sportscaster	sportscast
sporulation	sporulate
spotting	spot
spotlight	spotlight
spousal	spouse
spout	spout
sprain	sprain
sprawling	sprawl
spraying	spray
spreading	spread
spree	spree
spring-cleaning	spring-clean
springer	spring
sprinkling	sprinkle
sprinter	sprint
sprouting	sprout
spruceness	spruce
spud	spud
spume	spume
spurring	spur
spurt	spurt
sputtering	sputter
spying	spy
squabble	squabble
squall	squall
squandering	squander
squareness	square
squash	squash
squatting	squat
squawker	squawk
squeaker	squeak
squealer	squeal
squeegee	squeegee
squeezer	squeeze
squelch	squelch
squinch	squinch
squint	squint
squire	squire
squirm	squirm
squirrel	squirrel
squirt	squirt
stab	stab
stabilization	stable	stabilise	stabilize
stablishment	stablish
stacks	stack
staffer	staff
stag	stag
staging	stage
staggerer	stagger
stagnation	stagnate
staining	stain
staking	stake
staleness	stale
stalemate	stalemate
stalking	stalk
stallion	stall
stammerer	stammer
stamp	stamp
stampede	stampede
stanchion	stanch
stationer	stand	station
standardization	standardise	standardize
standoff	standoff
stapler	staple
star	star
starboard	starboard
starch	starch
stare	stare
stargazing	stargaze
starting	start
startle	startle
starvation	starve
stash	stash
statement	state
staunchness	staunch
stave	stave
stayman	stay
steadiness	steady
stealing	steal
steamship	steam
steamroller	steamroller
steelman	steel
steepness	steep
steeplechasing	steeplechase
steering	steer
stellification	stellify
stem	stem
stencil	stencil
steps	step
stereotype	stereotype
sterilization	sterilise	sterilize
stewing	stew
stewardship	steward
stickiness	stick
stiffening	stiffen
stifling	stifle
stigmatization	stigmatise	stigmatize
stillness	still
stimulation	stimulate
stinging	sting
stinker	stink
stint	stint
stipulation	stipulate
stirring	stir
stitching	stitch
stocking	stock
stockade	stockade
stockpiling	stockpile
stoker	stoke
stomacher	stomach
stomp	stomp
stone	stone
stonewalling	stonewall
stooge	stooge
stool	stool
stoop	stoop
stopping	stop
stopper	stopper
storing	store
storm	storm
stowing	stow
straddle	straddle
straggler	straggle
straining	strain
strand	strand
strangulation	strangle	strangulate
strap	strap
stratification	stratify
straw	straw
stray	stray
streaker	streak
streaming	stream
streamliner	streamline
streetwalker	streetwalk
stress	stress
stretching	stretch
strewing	strew
striation	striate
stridency	stride
stridulation	stridulate
striving	strive
striking	strike
stringer	string
stripping	strip
striping	stripe
stroking	stroke
stroller	stroll
strengthening	strengthen
strop	strop
struggle	struggle
strum	strum
strut	strut
stub	stub
stucco	stucco
student	stud
studying	study
stuffing	stuff
stultification	stultify
stumble	stumble
stumping	stump
stunting	stunt
stupefaction	stupefy	stupify
stuttering	stutter
stylization	style	stylise	stylize
stymie	stymy	stymie
subbing	sub
subcontractor	subcontract
subdivision	subdivide
subduction	subduct
subdual	subdue
subeditor	subedit
suberization	suberise	suberize
subinfeudation	subinfeudate
subirrigation	subirrigate
subjectiveness	subject
subjectification	subjectify
subjunctive	subjoin
subjugation	subjugate
sublease	sublease
sublet	sublet
sublimination	sublime	sublimate
submersible	submerge	submerse
subminiaturization	subminiaturise	subminiaturize
submissiveness	submit
subordinateness	subordinate
subornation	suborn
subpoena	subpoena
subrogation	subrogate
subscription	subscribe
subservientness	subserve
subsidization	subside	subsidize	subsidise
subsistence	subsist
substantialness	substantiate
substantivization	substantivise	substantivize
substitutability	substitute
subsumption	subsume
subtension	subtend
subtilization	subtilise	subtilize
subtitle	subtitle
subtraction	subtract
subvention	subvene
subversiveness	subvert
successiveness	succeed
succor	succor
succour	succour
succussion	succuss
suction	suck	suction
suckling	suckle
sudan	sudanize
suds	suds
suiting	sue	suit
suede	suede
sufferance	suffer
sufficiency	suffice
suffixation	suffix
sufflation	sufflate
suffocation	suffocate
suffumigation	suffumigate
suffusion	suffuse
sugar	sugar
suggestibility	suggest
sulfation	sulfate
sulphonation	sulfonate	sulphonate
sulfurization	sulfurize
sulk	sulk
sulphation	sulphate
sulphurization	sulphur	sulphurise	sulphurize	sulphurate
summation	sum	summate
summarization	summarise	summarize
summer	summer	summerize
summoning	summon	summons
sun	sun
sunbather	sunbathe
sunburn	sunburn
sunday	sunday
sunderance	sunder
suntan	suntan
supping	sup
superaddition	superadd
superannuation	superannuate
supercharger	supercharge
supererogation	supererogate
superfusion	superfuse
superimposition	superimpose
superinducement	superinduce
superintendence	superintend
superposition	superpose
superscription	superscribe
supersession	supersede
supervenience	supervene
supervision	supervise
supination	supinate
supplantation	supplant
supplementation	supplement
supplication	supplicate
supplying	supply
supporting	support
supposition	suppose
suppression	suppress
suppuration	suppurate
surcession	surcease
surcharge	surcharge
surfing	surf
surfacing	surface
surfeit	surfeit
surge	surge
surmise	surmise
surname	surname
surpass	surpass
surprising	surprise
surrender	surrender
surrogation	surrogate
surroundings	surround
surtax	surtax
surveillance	surveil
surveying	survey
survivor	survive
suspicion	suspect
suspenders	suspend
suspiration	suspire
sustainability	sustain
susurration	susurrate
suturing	suture
swabbing	swab
swag	swag
swaggerer	swagger
deglutition	swallow
swamp	swamp
swan	swan
swank	swank
swap	swap
swarm	swarm
swash	swash
swashbuckling	swashbuckle
swat	swat
swathing	swathe
swatter	swatter
sway	sway
swearing	swear
sweating	sweat
sweeping	sweep
sweet-talk	sweet-talk
sweetening	sweeten
swelling	swell
swerving	swerve
swig	swig
swilling	swill
swimming	swim
swindler	swindle
swinging	swing	swinge
swink	swink
swipe	swipe
swirl	swirl
swish	swish
switchman	switch
swivel	swivel
swob	swob
swoon	swoon
swoop	swoop
swop	swop
swot	swot
syllabification	syllabify	syllabize	syllabicate	syllabification
syllogization	syllogise	syllogize
symbolization	symbolise	symbolize
symmetrization	symmetrize	symmetrise
sympathizer	sympathise	sympathize
symphony	symphonize
synchronization	synchronise	synchronize
syncopation	syncopate
syncretization	syncretise	syncretize
syndication	syndicate
synonymousness	synonymise	synonymize
synopsization	synopsise	synopsize
synthetization	synthesise	synthesize
syphering	sypher
syphon	syphon
syringe	syringe
systematization	systemize	systematize
tableful	table	tabularize
taboo	taboo
tabulation	tabulate
tacking	tack
tackling	tackle
tag	tag
tailing	tail
tailgate	tailgate
tailoring	tailor
taint	taint
takings	take
talc	talc
talkativeness	talk
tallyman	tally
tameness	tame
tampering	tamp	tamper
tannage	tan
tanglement	tangle
tango	tango
tankful	tank
tantalization	tantalise	tantalize
tapping	tap
taping	tape
tapering	taper
tar	tar
target	target
tariff	tariff
tarmac	tarmac
tarnish	tarnish
tarriance	tarry
tartarization	tartarise	tartarize
task	task
tassel	tassel
tastefulness	taste
tatting	tat	tatt
tatter	tatter
tattler	tattle
tattoo	tattoo
taunting	taunt
taxation	tax
taximan	taxi
te-hee	te-hee
teaching	teach
team	team
tearfulness	tear
teasing	tease
tee	tee
telecasting	telecast
telecommunication	telecommunicate
telegraphist	telegraph
telephonist	telephone
telescope	telescope
television	televise
telex	telex
telling	tell
temperateness	temper
temporization	temporise	temporize
temptation	tempt
tenancy	tenant
tendentiousness	tend
tenderization	tender	tenderise	tenderize
tenseness	tense
tenting	tent
tenure	tenure
tepefaction	tepefy
tergiversation	tergiversate
termite	term
termination	terminate
terrace	terrace
territorialization	territorialise	territorialize
terrorization	terrify	terrorise	terrorize
tessellation	tesselate	tessellate
testing	test
testification	testify
tetanization	tetanise	tetanize
tether	tether
teutonization	teutonise	teutonize
texture	texture
thankfulness	thank
thatcher	thatch
thawing	thaw
theologization	theologise	theologize
theorisation	theorise	theorize
thermostatics	thermostat
thickening	thicken
thieving	thieve
thinning	thin
thoughtfulness	think
thirst	thirst
thrashing	thrash
threads	thread
threat	threaten
threshing	thresh
thriller	thrill
throbbing	throb
thrombosis	thrombose
throne	throne
throng	throng
throttling	throttle
thrower	throw
thrum	thrum
thrusting	thrust
thud	thud
thumb	thumb
thumbtack	thumbtack
thumping	thump
thunderer	thunder
thunk	thunk
thwack	thwack
thwarting	thwart
ticking	tick
ticket	ticket
tickling	tickle
ticktack	ticktack
ticktock	ticktock
tidings	tide
tidiness	tidy
tying	tie	tying
tightening	tighten
tiling	tile
tilling	till	tiller
tilt	tilt
timing	time
timetable	timetable
tinning	tin
tincture	tincture
tinge	ting	tinge
tingling	tingle
tinker	tinker
tinkle	tinkle
tinsel	tinsel
tinting	tint
tintinnabulation	tintinnabulate
tip	tip
tippler	tipple
tiptoe	tiptoe
tiresomeness	tire
tissue	tissue
tithing	tithe
titillation	titillate
tittivation	titivate	tittivate
title	title
titration	titrate
titter	titter
tittle-tattle	tittle-tattle
titubation	titubate
toe	toe
toady	toady
toasting	toast
tobogganist	toboggan
toddler	toddle
togs	tog
toggle	toggle
toilsomeness	toil
tolerability	tolerate
tollman	toll
tomahawk	tomahawk
tone	tone
tongue-lashing	tongue-lash
tongue	tongue
tonsure	tonsure
tool	tool
toot	toot
tootle	tootle
topping	top	tope
topple	topple
torch	torch
tormentor	torment
torpedo	torpedo
torrifaction	torrefy	torrify
torturing	torture
toss	toss
tot	tot
totalitarianism	total	totalise	totalize
toter	tote
totter	totter
touching	touch
touchdown	touchdown
tourist	tour
tourney	tourney
tout	tout
tow	tow
towelling	towel
tower	tower
toying	toy
traction	trace
tracking	track
trading	trade
traducement	traduce
trafficator	traffic
trailing	trail
trainman	train
trajectory	traject
tram	tram
trammels	trammel
tramp	tramp
trampling	trample
trance	trance
transparentness	transparent
tranquillization	tranquilize	tranquillize
transactions	transact
transcendentalism	transcend
transconductance	transconduct
transcription	transcribe
transduction	transduce
transection	transect
transferability	transfer
transfigurement	transfigure
transfixion	transfix
transformation	transform
transfusion	transfuse
transgression	transgress
transshipment	tranship	transship
transillumination	transilluminate
transistorization	transistorise	transistorize
transitiveness	transit
translation	translate
transliteration	transliterate
translocation	translocate
transmigration	transmigrate
transmittance	transmit
transmogrification	transmogrify
transmutability	transmute
transpiration	transpire	transpirate
transplantation	transplant
transponder	transponder
transportation	transport
transposability	transpose
transubstantiation	transubstantiate
transudation	transude
transvaluation	transvalue
transversal	transverse
trappings	trap
trash	trash
traumatization	traumatise	traumatize
travail	travail
travelling	travel
traversal	traverse
travesty	travesty
trawler	trawl
tread	tread
treadle	treadle
treasurer	treasure
treatment	treat
treble	treble
tree	tree
trek	trek
trellis	trellis
trembling	tremble
tremor	tremor
trencher	trench
trend	trend
trepanation	trepan
trephination	trephine
trespasser	trespass
triangle	triangle
triangulation	triangulate
tribulation	tribulate
trice	trice
trichinization	trichinise	trichinize
trickery	trick
trickle	trickle
trident	trident
trifling	trifle
trifurcation	trifurcate
trigger	trigger
trillions	trill
trimness	trim
trip	trip
triple-spacing	triple-space
triple-tonguing	triple-tongue
tripling	triple
triplication	triplicate
trisection	trisect
tritiation	tritiate
trituration	triturate
triumph	triumph
trivialization	trivialise	trivialize
troller	troll
trolley	trolley
troopship	troop
tropicalization	tropicalise	tropicalize
trot	trot
troublesomeness	trouble
trouncing	trounce
trowel	trowel
truancy	truant
trucking	truck
truckling	truckle
trudge	trudge
truthfulness	true
trumping	trump
trumpeter	trumpet
truncation	truncate
truncheon	truncheon
trundle	trundle
truss	truss
trustfulness	trust
tryst	try
tubing	tube
tubulation	tubulate
tucker	tuck	tucker
tuft	tuft
tug	tug
tumbling	tumble
tumefaction	tumefy
tunefulness	tune
tunnel	tunnel
turf	turf
turning	turn
tusk	tusk
tussle	tussle
tutorship	tutor
twaddle	twaddle
twang	twang
tweak	tweak
tweeter	tweet
twiddle	twiddle
twig	twig
twill	twill
twin	twin
twine	twine
twinge	twinge
twinkling	twinkle
twirler	twirl
twirp	twirp
twisting	twist
twitting	twit
twitching	twitch
twitter	twitter
typification	type	typify
typewriting	typewrite
tyranny	tyrannise	tyrannize
uglification	uglify
ulceration	ulcerate
ultracentrifugation	ultracentrifuge
ululation	ululate
umpireship	umpire
unbalance	unbalance
uncovering	uncover
undercharge	undercharge
undercoat	undercoat
undercut	undercut
underdevelopment	underdevelop
underdrainage	underdrain
underestimation	underestimate
underexposure	underexpose
underline	underline
undernourishment	undernourish
underpayment	underpay
underpinning	underpin
underrating	underrate
underscore	underscore
understandability	understand
understatement	understate
understudy	understudy
undertaking	undertake
undervaluation	undervalue
underwriter	underwrite
undoing	undo
undress	undress
undulation	undulate
unearth	unearth
unfastening	unfasten
unfitness	unfit
unfolding	unfold
unhorse	unhorse
uniformness	uniform	uniformize
unification	unify
unitarianism	unite	unitize	unionise	unionize
universalization	universe	universalise	universalize
unlikeness	unlike
unloading	unload
unmasking	unmask
unravelment	unravel
unsettlement	unsettle
unsnarling	unsnarl
untangling	untangle
untying	untie
unveiling	unveil
upbraiding	upbraid
updating	update
upending	upend
upgrade	upgrade
upheaval	upheave
upholsterer	upholster
upliftment	uplift
upload	upload
uprightness	upright
uprising	uprise
upset	upset
upspring	upspring
upswing	upswing
urbanization	urbanise	urbanize
urgency	urge
urination	urinate
urtication	urticate
usefulness	use
usher	usher
usurpation	usurp
utilitarianism	utilise	utilize
utterance	utter
vacationist	vacate	vacation
vaccination	vaccinate
vacillation	vacillate
vacuum	vacuum
vagabond	vagabond
valet	valet
validating	validate
valorousness	valorise	valorize
valuation	value	valuate
vamper	vamp
vandalization	vandalise	vandalize
vanishment	vanish
vanquishment	vanquish
vaporization	vapor	vaporise	vaporize
variegation	variegate
variolization	variolate
varnish	varnish
variableness	vary	variate
vaticination	vaticinate
vaulting	vault
vaunter	vaunt
vector	vector
veering	veer
vegetation	vegetate
veiling	veil
vein	vein
velarization	velarize	velarise
velcro	velcro
vellication	vellicate
vendition	vend
veneering	veneer
venerability	venerate
vengefulness	venge	avenge
venting	vent
ventilation	ventilate
ventriloquization	ventriloquise	ventriloquize
venturesomeness	venture
verbalization	verbalise	verbalize
verbification	verbify
verdigris	verdigris
verge	verge
verification	verify
vermiculation	vermiculate
vermilion	vermilion
vernalization	vernalise	vernalize
verse	verse
versification	versify
vesication	vesicate
vesiculation	vesiculate
vestment	vest
vesture	vesture
vet	vet
veto	veto
vexation	vex
vibrations	vibrate
victimization	victimise	victimize
victualler	victual
videotape	videotape
vial	vie	vying
viewing	view
vignette	vignette
vilification	vilify
vindication	vindicate
violability	violate
visa	visa
visitation	visit
visualization	visual	visualise	visualize
vitalization	vitalise	vitalize
vitamine	vitaminize
vitiation	vitiate
vitrification	vitrify
vitriolization	vitriolise	vitriolize
vituperation	vituperate
vivification	vivify
vivisection	vivisect
vocalization	vocalise	vocalize
vociferation	vociferate
voice	voice
voidance	void
volatilization	volatilise	volatilize
volcanization	volcanize	volcanise
volley	volley
volunteer	volunteer
vomiturition	vomit
voodoo	voodoo
voting	vote
vouch	vouch
vouchsafement	vouchsafe
vow	vow
vowelization	vowelise	vowelize
voyager	voyage
vulcanization	vulcanise	vulcanize
vulgarization	vulgarise	vulgarize
wadding	wad
waddle	waddle
wading	wade
wadset	wadset
waffle	waffle
wafture	waft
wag	wag
wages	wage
wagerer	wager
waggle	waggle
wailing	wail
wainscotting	wainscot
waitress	wait	await
waiver	waive
wakefulness	wake
wakening	waken
walking	walk
wall	wall
walloping	wallop
wallow	wallow
wallpaper	wallpaper
waltz	waltz
wanness	wan	wane
wandering	wander
wangling	wangle
wank	wank
want	want
wantonness	wanton
warship	war
warbler	warble
ward	ward
wares	ware
warehouser	warehouse
warmness	warm
warning	warn
warping	warp
warrantor	warrant
washing	wash
wassailer	wassail
wastefulness	waste
watchfulness	watch
water-skiing	water-ski
waterman	water
watercolor	watercolor
waterproofing	waterproof
wattle	wattle
waving	wave
wavering	waver
waxing	wax
weakening	weaken
weaning	wean
wearing	wear
weariness	weary
weasel	weasel
weatherman	weather
weaving	weave
webbing	web
wedding	wed
wedge	wedge
wee-wee	wee-wee
weeness	wee
weeds	weed
weekender	weekend
weepiness	weep
weighting	weigh	weight
weightlifting	weightlift
welcher	welch
welcoming	welcome
weldment	weld
well	well
welshman	welsh
welt	welt
welter	welter
wench	wench
westernization	westernize	westernise
wetting	wet
whacking	whack
whale	whale
wham	wham
whang	whang
wheedling	wheedle
wheeling	wheel
wheeziness	wheeze
whelk	whelk
whelp	whelp
whet	whet
whiff	whiff
while	while
whimpering	whimper
whiner	whine
whinny	whinny
whipping	whip
whipsaw	whipsaw
whirring	whir
whirling	whirl
whirligig	whirligig
whirlpool	whirlpool
whirr	whirr
whish	whish
whiskers	whisk	whisker
whispering	whisper
whistling	whistle
whiteness	white
whitening	whiten
whitewash	whitewash
whizz	whiz	whizz
wholesaler	wholesale
whooper	whoop
whoosh	whoosh
whop	whop
whoredom	whore
whump	whump
widening	widen
widower	widow
wigging	wig
wiggliness	wiggle
wildcatting	wildcat
wilderness	wilder
willfulness	will
wilting	wilt
winsomeness	win
wince	wince
winch	winch
winding	wind
window-shopping	window-shop
winemaking	wine
wingman	wing
winker	wink
winkle	winkle
winnowing	winnow
winterization	winter	winterize	winterise
wiper	wipe
wiring	wire
wireless	wireless
wiretap	wiretap
wisecrack	wisecrack
wishfulness	wish
witness	wit	witness
witchery	witch
withdrawnness	withdraw
withering	wither
withholding	withhold
wobbler	wobble
wolfman	wolf
womanization	womanise	womanize
wonderfulness	wonder
wont	wont
wooing	woo
woof	woof
woolgathering	woolgather
wording	word
work-hardening	work-harden
workings	work
worm	worm
worriment	worry
worsening	worsen
worshiper	worship
worsted	worst
wounding	wound
wow	wow
wrack	wrack
wrangling	wrangle
wrapping	wrap
wreath	wreath	wreathe
wrecking	wreck
wrench	wrench
wrest	wrest
wrestling	wrestle
wrick	wrick
wriggler	wriggle
wringer	wring
wrinkle	wrinkle
writings	write
writhe	writhe
wrongfulness	wrong
x-raying	x-ray
xerox	xerox
yachting	yacht
yack	yack
yak	yak
yankee	yank
yap	yap
yarn	yarn
yaws	yaw
yawl	yawl
yawn	yawn
yearning	yearn
yelling	yell
yellowness	yellow
yelping	yelp
yen	yen
yielding	yield
yip	yip
yodeller	yodel
yoke	yoke
yowling	yowl
zag	zag
zero	zero
zestfulness	zest
zig	zig
zigzag	zigzag
zing	zing
zip	zip
zipper	zipper
zoning	zone
zoom	zoom
