abandon	abandon
abandonment	abandon
abatement	abate
abidance	abide
abolition	abolish
abolishment	abolish
abortion	abort
abundance	abound
absence	absent
absentee	absent
absenteeism	absent
absolute	absolve
absolver	absolve
absolution	absolve
absolutism	absolve
absoluteness	absolve
absorber	absorb
absorbent	absorb
absorbate	absorb
absorbency	absorb
absorption	absorb
absorptance	absorb
absorptivity	absorb
abstainer	abstain
abstinent	abstain
abstention	abstain
abstinence	abstain
abstract	abstract
abstracter	abstract
abstractor	abstract
abstraction	abstract
abstractness	abstract
abuse	abuse
abuser	abuse
ac	ace
ace	ace
accedence	accede
accelerator	accelerate
acceleration	accelerate
accent	accent	accentuate
accentor	accent	accentuate
accenting	accent	accentuate
accentuation	accent	accentuate
acceptor	accept
acceptance	accept
acceptation	accept
acceptability	accept
acceptableness	accept
access	access	accession
accession	access	accession
accessibility	access	accession
acclaim	acclaim
acclamation	acclaim
accommodation	accommodate
accompanist	accompany
accompanyist	accompany
accompaniment	accompany
accomplishment	accomplish
accord	accord
accordion	accord
accordance	accord
account	account
accounting	account
accountant	account
accountancy	account
accountability	account
accrual	accrue
accrument	accrue
accruement	accrue
accumulator	accumulate
accumulation	accumulate
accusal	accuse
accused	accuse
accuser	accuse
accusation	accuse
accusative	accuse
ache	ache
aching	ache
achiever	achieve
achievement	achieve
achievability	achieve
acknowldgement	acknowledge
acknowledgment	acknowledge
acknowledgement	acknowledge
acquaintance	acquaint
acquiescence	acquiesce
acquirer	acquire
acquiring	acquire
acquirement	acquire
acquisition	acquire
acquisitiveness	acquire
act	act
acts	act
actor	act
acting	act
actress	act
action	activate
active	activate
activity	activate
activator	activate
activating	activate
activation	activate
activeness	activate
actuator	actuate
actuation	actuate
adapter	adapt
adaptor	adapt
adaptation	adapt
adaptability	adapt
adder	add
addition	add
additive	add
address	address
addressee	address
adducing	adduce
adduction	adduce
adherent	adhere
adhesion	adhere
adhesive	adhere
adherence	adhere
adhesiveness	adhere
adjournment	adjourn
adjudicator	adjudicate
adjudication	adjudicate
adjuster	adjust
adjustor	adjust
adjustment	adjust
administrator	administer
administration	administer
admiral	admire
admirer	admire
admiration	admire
admirability	admire
admirableness	admire
admission	admit
admittance	admit
admissibility	admit
adoption	adopt
adorer	adore
adoration	adore
adorability	adore
adorableness	adore
adornment	adorn
advance	advance
advancement	advance
advantage	advantage
advantageousness	advantage
adventure	adventure
adventurer	adventure
adventurism	adventure
adventurousness	adventure
advertiser	advertise
advertising	advertise
advertisement	advertise
advice	advise
advisee	advise
adviser	advise
advisor	advise
advisory	advise
advisement	advise
advisability	advise
advocacy	advocate
advocate	advocate
advocation	advocate
aerator	aerate
aeration	aerate
affect	affect
affection	affect
affectation	affect
affectionateness	affect
affiliate	affiliate
affiliation	affiliate
affirmation	affirm
affirmative	affirm
affirmativeness	affirm
affix	affix
affixation	affix
affront	affront
ag	age
age	age
aged	age
agent	age
agism	age
aging	age
ageism	age
ageing	age
agglomeration	agglomerate
aggravation	aggravate
aggregate	aggregate
aggregation	aggregate
agitator	agitate
agitation	agitate
agreement	agree
aid	aid
aide	aid
aids	aid
aides	aid
aim	aim
air	air
aire	air
airs	air
airing	air
airman	air
airship	air
airlift	airlift
airmail	airmail
alarm	alarm
alarmism	alarm
alarmist	alarm
alert	alert
alerting	alert
alertness	alert
alibi	alibi
alien	alien	alienate
alienism	alien	alienate
alienation	alien	alienate
alignment	align
allegation	allege
allegement	allege
alleviation	alleviate
alligator	alligator
allocation	allocate
allotment	allot
allowance	allow	allowance
alloy	alloy
allure	allure
allurement	allure
ally	ally
allis	ally
allies	ally
alliance	ally
altering	alter
alteration	alter
alterability	alter
alternant	alternate
alternate	alternate
alternator	alternate
alternation	alternate
alternative	alternate
amassment	amass
amazement	amaze
ambit	ambition
ambition	ambition
ambuscade	ambuscade
ambush	ambush
amends	amend
amendment	amend
amnesty	amnesty
amortization	amortize
amount	amount
amplifier	amplify
amplification	amplify
amusement	amuse
anagram	anagram
anagrams	anagram
analyser	analyze
analysis	analyze
analyzer	analyze
analyticity	analyze
analyzation	analyze
anchor	anchor
anchorage	anchor
anchorite	anchor
anchorman	anchor
anger	anger
angriness	anger
angle	angle
angler	angle
angling	angle
angularity	angle
anguish	anguish
anime	animate
animal	animate
animism	animate
animalism	animate
animatism	animate
animality	animate
animation	animate
animateness	animate
animalisation	animate
animalization	animate
annex	annex
annexe	annex
annexation	annex
annihilation	annihilate
announcer	announce
anunciation	announce
announcement	announce
annoyer	annoy
annoying	annoy
annoyance	annoy
annulment	annul
answer	answer
answerer	answer
answerability	answer
answerableness	answer
ant	ante
ante	ante
antagonist	antagonise	antagonize
antagonism	antagonise	antagonize
antagonisation	antagonise	antagonize
antagonization	antagonise	antagonize
antelope	antelope
antic	antic
anticipation	anticipate
antidote	antidote
antique	antique
antiquity	antique
antiquation	antique
ape	ape
aper	ape
apology	apologize
apologist	apologize
apologetics	apologize
apparel	apparel
appeal	appeal
appellant	appeal
appellation	appeal
appellative	appeal
appearing	appear
appearance	appear
appeaser	appease
appeasement	appease
applause	applaud
applauder	applaud
applier	apply
applicant	apply
appliance	apply
applicator	apply
application	apply
applicability	apply
appointee	appoint
appiontment	appoint
appointment	appoint
apportioning	apportion
apportionment	apportion
appraisal	appraise
appraiser	appraise
appreciation	appreciate
appreciativeness	appreciate
apprehension	apprehend
apprehensiveness	apprehend
apprentice	apprentice
apprenticeship	apprentice
approach	approach
approaching	approach
approachability	approach
appropriation	appropriate
appropriateness	appropriate
approval	approve
approving	approve
approximant	approximate
approximation	approximate
arbitrage	arbitrage
arbitrager	arbitrage
arbitrator	arbitrate
arbitrament	arbitrate
arbitration	arbitrate
arbitrement	arbitrate
arc	arc
arch	arch
archer	arch
archness	arch
argus	argue
arguer	argue
arguing	argue
argument	argue
argumentation	argue
arm	arm	armor
arms	arm	armor
armor	arm	armor
armful	arm	armor
arming	arm	armor
armorer	arm	armor
armament	arm	armor
arousal	arouse
arranger	arrange
arranging	arrange
arrangement	arrange
array	array
arrayal	array
arrest	arrest
arrester	arrest
arrival	arrive
arriver	arrive
arrogance	arrogate
arrogation	arrogate
article	article
articulation	articulate
articulateness	articulate
ascent	ascend
ascendant	ascend
ascension	ascend
ascendent	ascend
ascending	ascend
ascendance	ascend
ascendancy	ascend
ascendence	ascend
ascendency	ascend
ascertainment	ascertain
ascription	ascribe
ash	ash
asker	ask
asking	ask
asphalt	asphalt
aspirant	aspire
aspirate	aspire
aspirator	aspire
aspiration	aspire
assailant	assail
assailment	assail
assailability	assail
assault	assault
assay	assay
assayal	assay
assembly	assemble
assembler	assemble
assemblage	assemble
assembling	assemble
assent	assent
assenting	assent
assertion	assert
asserttion	assert
assertiveness	assert
assess	assess
assessor	assess
assessment	assess
assignee	assign
assigning	assign
assignment	assign
assignation	assign
assimilation	assimilate
assist	assist
assistant	assist
assistance	assist
associate	associate
association	associate
associability	associate
associableness	associate
assumption	assume
assur	assure
assurance	assure
ation	protest
protest	protest
protester	protest
protestant	protest
protestation	protest
atonal	atone
atonality	atone
atonement	atone
atonalism	atone
atonicity	atone
atrophy	atrophy
attache	attach
attachment	attach
attack	attack
attacker	attack
attainment	attain
attainability	attain
attainableness	attain
attempt	attempt
attender	attend
attention	attend
attendant	attend
attending	attend
attendance	attend
attentiveness	attend
attestant	attest
attestation	attest
attire	attire
attraction	attract
attractiveness	attract
attribute	attribute
attribution	attribute
auction	auction	auctioneer
auctioneer	auction	auctioneer
audit	audit	audition
auditor	audit	audition
audition	audit	audition
augmentation	augment
augur	augur
augury	augur
authenticity	authenticate
authentication	authenticate
author	author	authorise	authorize
authority	author	authorise	authorize
authorities	author	authorise	authorize
authoritarian	author	authorise	authorize
authorisation	author	authorise	authorize
authorization	author	authorise	authorize
authoritarianism	author	authorise	authorize
autograph	autograph
automat	automate
automate	automate
automatic	automate
automation	automate
automatism	automate
automatization	automate
automobile	automobile
autopsy	autopsy
avail	avail
availability	avail
availableness	avail
avalanche	avalanche
averment	aver
average	average
averageness	average
aversion	avert
averting	avert
avoidance	avoid
awe	awe
awfulness	awe
awakening	awaken
award	award
awarding	award
ax	ax	axe
axe	ax	axe
baby	baby
bachelor	bachelor
back	back
backer	back
backing	back
background	background
backgrounding	background
backlash	backlash
backlog	backlog
backpack	backpack
backpacking	backpack
backstitch	backstitch
backstop	backstop
badge	badge
baffle	baffle
baffled	baffle
bafflement	baffle
bag	bag
bagful	bag
bagman	bag
baggage	bag
bagging	bag
bai	bay
bay	bay
bayer	bay
bail	bail
bailment	bail
bait	bait
baiting	bait
bake	bake
baker	bake
bakery	bake
baking	bake
balance	balance
balancer	balance
balancing	balance
baldy	bald
baldness	bald
bale	bale
balefulness	bale
ball	ball
ballast	ballast
balloon	balloon
ballooning	balloon
balloonist	balloon
ballot	ballot
balloting	ballot
ballyhoo	ballyhoo
ban	ban
banning	ban
band	band
banding	band
bandage	bandage
bandaging	bandage
bang	bang
banger	bang
banging	bang
banishment	banish
bank	bank
banker	bank
banking	bank
bankrupt	bankrupt
bankruptcy	bankrupt
banquet	banquet
banqueting	banquet
banter	banter
bar	bar
bars	bar
barman	bar
barring	bar
barbecue	barbecue
barbecuing	barbecue
barber	barber
bard	bard
barite	bare
baring	bare
bareness	bare
bargain	bargain
bargainer	bargain
bargaining	bargain
barge	barge
bargee	barge
bargeman	barge
bark	bark
barker	bark
barkeep	barkeep
barkeeper	barkeep
barrack	barrack
barracks	barrack
barracking	barrack
barrage	barrage
barrel	barrel
barrels	barrel
barrelful	barrel
barricade	barricade
barter	barter
barterer	barter
base	base
baseness	base
bat	bat
batman	bat
batting	bat
batch	batch
bath	bath	bathe
bathe	bath	bathe
bather	bath	bathe
bathing	bath	bathe
batten	batten
batter	batter
battery	batter
battering	batter
battle	battle
battler	battle
battlement	battle
battleship	battle
bayonet	bayonet
be	be
being	be
beach	beach
beacon	beacon
beam	beam
bear	bear
bearer	bear
bearing	bear
beard	beard
beat	beat
beater	beat
beating	beat
beauty	beautify
beautician	beautify
beautification	beautify
beaver	beaver
bebop	bebop
bed	bed
bedding	bed
bedevilment	bedevil
beef	beef
beep	beep
beetle	beetle
beggar	beg	beggar
beggary	beg	beggar
begging	beg	beggar
beggarman	beg	beggar
beginning	begin
beguilement	beguile
behavior	behave
behaviorism	behave
beholder	behold
beholding	behold
belch	belch
belching	belch
belief	believe
believer	believe
believing	believe
believability	believe
bell	bell
belle	bell
belling	bell
bellman	bell
bellow	bellow
bellows	bellow
bellowing	bellow
belly	belly
bellis	belly
bellyful	belly
belonging	belong
belongings	belong
belt	belt
belting	belt
bench	bench
bend	bend
bends	bend
bender	bend
bending	bend
benefit	benefit
benefaction	benefit
berry	berry
berth	berth
besieger	besiege
besieging	besiege
best	best
bestowal	bestow
bestowment	bestow
bet	bet
betrayal	betray
betrayer	betray
better	better
betterment	better
bevel	bevel
bias	bias
bib	bib
bicycle	bicycle
bicycling	bicycle
bicyclist	bicycle
bid	bid
bidding	bid
bilge	bilge
bilges	bilge
bill	bill
billing	bill
billion	bill
billings	bill
billions	bill
billet	billet
bin	bin
binful	bin
bind	bind
binder	bind
bindery	bind
binding	bind
binge	binge
bio-assay	bio-assay
birch	birch
bird	bird
birding	bird
birdie	birdie
birth	birth
birthing	birth
bishop	bishop
bitch	bitch
bite	bite
biter	bite
bitter	bitter
bitters	bitter
bitterness	bitter
bivouac	bivouac
black	black
blacking	black
blackness	black
blackberry	blackberry
blackjack	blackjack
blackmail	blackmail
blackmailer	blackmail
blame	blame
blank	blank
blankness	blank
blanket	blanket
blast	blast
blaze	blaze
blazer	blaze
blazing	blaze
blazon	blazon
blazoning	blazon
blazonment	blazon
bleat	bleat
bleeder	bleed
bleeding	bleed
blemish	blemish
blemishment	blemish
blend	blend
blende	blend
blender	blend
blending	blend
blessing	bless
blight	blight
blighter	blight
blind	blind
blinder	blind
blindness	blind
blink	blink
blinks	blink
blinker	blink
blister	blister
blitz	blitz
bloat	bloat
blob	blob
block	block
blocker	block
blockage	block
blocking	block
blockade	blockade
blood	blood	bloody
bloom	bloom
blooming	bloom
blossom	blossom
blossoming	blossom
blot	blot
blow	blow
blower	blow
blowing	blow
blubber	blubber
bludgeon	bludgeon
blue	blue
blues	blue
blueing	blue
blueness	blue
blueprint	blueprint
bluff	bluff
bluffer	bluff
bluffness	bluff
blunder	blunder
blunderer	blunder
bluntness	blunt
blur	blur
blush	blush
blusher	blush
bluster	bluster
blusterer	bluster
board	board
boards	board
boarder	board
boarding	board
boast	boast
boaster	boast
boasting	boast
boastfulness	boast
boat	boat
boater	boat
boating	boat
boatman	boat
boding	bode
bodement	bode
body	body
bog	bog
bogey	bogey
bogeyman	bogey
boil	boil
boiler	boil
boiling	boil
bolster	bolster
bolt	bolt
bomb	bomb
bomber	bomb
bombast	bomb
bombing	bomb
bond	bond
bonding	bond
bondman	bond
bone	bone
boner	bone
bones	bone
boniness	bone
bonnet	bonnet
boo	boo
boogie	boogie
book	book
booker	book
booking	book
bookshelf	bookshelf
boom	boom
boomer	boom
boomerang	boomerang
boost	boost
booster	boost
boosters	boost
boot	boot
bootee	boot
bootes	boot
bootees	boot
booze	booze
boozer	booze
boozing	booze
bop	bop
border	border
borderer	border
bore	bore
borer	bore
boring	bore
boredom	bore
borrower	borrow
borrowing	borrow
bosom	bosom
boss	boss
bossism	boss
bother	bother
botheration	bother
bottle	bottle
bottleful	bottle
bottleneck	bottleneck
bottom	bottom
bounce	bounce
bouncer	bounce
bouncing	bounce
bounciness	bounce
bound	bound
bounds	bound
bounder	bound
boundary	bound
bow	bow	bower
bower	bow	bower
bowman	bow	bower
bowing	bow	bower
bowl	bowl
bowls	bowl
bowler	bowl
bowlful	bowl
bowling	bowl
box	box
boxer	box
boxful	box
boxing	box
boycott	boycott
brace	brace
bracer	brace
braces	brace
bracing	brace
bracket	bracket
brad	brad
brag	brag
bragging	brag
braggadocio	brag
brain	brain
brake	brake
brakes	brake
brakeman	brake
branch	branch
branching	branch
embranchment	branch
brand	brand
branding	brand
brave	brave
bravery	brave
braving	brave
brawl	brawl
brawler	brawl
brazenness	brazen
breach	breach	broach
broach	breach	broach
bread	bread
break	break
breaker	break
breakage	break
breakers	break
breaking	break
breakfast	breakfast
breast	breast
breath	breathe
breather	breathe
breathing	breathe
breed	breed
breeder	breed
breeding	breed
breeze	breeze
breeziness	breeze
brew	brew
brewer	brew
brewage	brew
brewery	brew
brewing	brew
bribe	bribe
briber	bribe
bribery	bribe
brick	brick
bridge	bridge
bridle	bridle
brief	brief
briefs	brief
brevity	brief
briefing	brief
briefness	brief
brigade	brigade
brim	brim
bringing	bring
briskness	brisk
bristle	bristle
broadcast	broadcast
broadcaster	broadcast
broadcasting	broadcast
broadening	broaden
broadside	broadside
brocade	brocade
broil	broil
broiler	broil
broiling	broil
broker	broker
bronze	bronze
brood	brood
brooder	brood
brooding	brood
brook	brook
broom	broom
brown	brown
browning	brown
brownness	brown
bruise	bruise
bruiser	bruise
brush	brush
brushing	brush
bubble	bubble
bubbly	bubble
bubbler	bubble
buck	buck
bucket	bucket
bucketful	bucket
buckle	buckle
buckler	buckle
bud	bud
budding	bud
budget	budget
buff	buff
buffalo	buffalo
buffer	buffer
buffet	buffet
buffeting	buffet
bug	bug
bugle	bugle
build	build
builder	build
building	build
bulge	bulge
bulk	bulk
bull	bull
bullion	bull
bulldozer	bulldoze
bulletin	bulletin
bullshit	bullshit
bully	bully
bullying	bully
bulwark	bulwark
bulwarks	bulwark
bum	bum
bump	bump
bumper	bump
bunch	bunch
bundle	bundle
bundling	bundle
bunk	bunk	bunker
bunker	bunk	bunker
bunt	bunt
bunting	bunt
buoy	buoy
buoyant	buoy
buoyancy	buoy
bur	burr
burr	burr
burring	burr
burden	burden
burdensomeness	burden
burial	bury
burier	bury
burying	bury
burl	burl
burlesque	burlesque
burn	burn
burner	burn
burning	burn
burrow	burrow
burst	burst
burster	burst
bus	bus	buss
buss	bus	buss
busful	bus	buss
busman	bus	buss
bussing	bus	buss
bush	bush
bushing	bush
bushel	bushel
bust	bust
buster	bust
bustle	bustle
busying	busy
business	busy
busyness	busy
butcher	butcher
butchery	butcher
butchering	butcher
butler	butler
butt	butt
butte	butt
butter	butter
button	button
buy	buy
buyer	buy
buying	buy
buzz	buzz
buzzer	buzz
bypass	bypass
cab	cab
cabbage	cabbage
cabin	cabin
cable	cable
cache	cache
cage	cage
cager	cage
cake	cake
calculator	calculate
calculation	calculate
calculability	calculate
calendar	calendar
calender	calender
caliper	caliper
calipers	caliper
call	call
caller	call
calling	call
calm	calm
calming	calm
calmness	calm
camouflage	camouflage
camp	camp
camper	camp
camping	camp
campion	camp
campaign	campaign
campaigner	campaign
campaigning	campaign
can	can
canful	can
cannery	can
canning	can
cancel	cancel
cancellation	cancel
candle	candle
candy	candy
cane	cane	canal
canal	cane	canal
caning	cane	canal
canalisation	cane	canal
canalization	cane	canal
canker	canker
cannon	cannon
cannoneer	cannon
canoe	canoe
canoeist	canoe
canopy	canopy
cant	cant
cantor	cant
canter	canter
canvas	canvas
canvass	canvass
canvasser	canvass
canvassing	canvass
cap	cap
capful	cap
caption	cap
caper	caper
capital	capitalize
capitate	capitalize
capitalism	capitalize
capitalist	capitalize
capitation	capitalize
capitalization	capitalize
capitalisation	capitalise
captain	captain
captaincy	captain
captainship	captain
capture	capture
caravan	caravan
caravanning	caravan
card	card
cards	card
care	care
caring	care
carefulness	care
career	career
careerism	career
careerist	career
caress	caress
caressing	caress
caricature	caricature
caricaturist	caricature
carpenter	carpenter
carpentry	carpenter
carpet	carpet
carpeting	carpet
carry	carry
carrier	carry
carriage	carry
cart	cart
carte	cart
carter	cart
carting	cart
cartoon	cartoon
carver	carve
carving	carve
cascade	cascade
cascades	cascade
case	case
casing	case
caseful	case
casement	case
cash	cash
cast	cast
caste	cast
caster	cast
castor	cast
casting	cast
castle	castle
castling	castle
cat	cat
catalog	catalog
cataloger	catalog
catalogue	catalogue
cataloguer	catalogue
catch	catch
catcher	catch
catching	catch
catchment	catch
catechism	catechize
catechist	catechize
catechesis	catechize
catechization	catechize
category	category	categorize
categorisation	category	categorize
categorization	category	categorize
caterer	cater
catering	cater
caucus	caucus
cause	cause
causing	cause
causation	cause
cauterisation	cauterize
cauterization	cauterize
caution	caution
cave	cave
caving	cave
cavern	cavern
cease	cease
cessation	cease
ceding	cede
cession	cede
celebrant	celebrate
celebrity	celebrate
celebrater	celebrate
celebrator	celebrate
celebration	celebrate
cellar	cellar
cement	cement
cementite	cement
cementation	cement
censure	censure
census	census
center	center	centre
centre	center	centre
central	center	centre
centred	center	centre
centrist	center	centre
centroid	center	centre
centering	center	centre
centrality	center	centre
centralisation	center	centre
centralization	center	centre
centigrade	centigrade
centrifuge	centrifuge
centrifugation	centrifuge
certificate	certify	certificate
certification	certify	certificate
chafe	chafe
chafing	chafe
chagrin	chagrin
chain	chain
chains	chain
chair	chair	chairman
chairman	chair	chairman
chalk	chalk
challenge	challenge
challenger	challenge
chamber	chamber
champion	champion
championship	champion
chance	chance
chang	change
change	change
changer	change
changefulness	change
channel	channel
channels	channel
channelization	channel
chant	chant
chanter	chant
chantry	chant
chanting	chant
chap	chap
chapman	chap
chaperon	chaperon	chaperone
chaperone	chaperon	chaperone
chaperonage	chaperon	chaperone
char	char
character	character	characterize
characterization	character	characterize
charcoal	charcoal
charge	charge
charger	charge
chariot	chariot
charioteer	chariot
charm	charm
charmer	charm
chart	chart
chartism	chart
chartist	chart
charter	charter
charterage	charter
chase	chase
chased	chase
chaser	chase
chat	chat
chatter	chatter
chatterer	chatter
chattering	chatter
chauffeur	chauffeur
chaw	chaw
cheat	cheat
cheater	cheat
cheating	cheat
check	check	checker
checker	check	checker
checkers	check	checker
cheek	cheek
cheekful	cheek
cheer	cheer
cheering	cheer
cheerfulness	cheer
cheese	cheese
chew	chew
chewing	chew
chiding	chide
chill	chill
chilling	chill
chin	chin
chip	chip
chipping	chip
chisel	chisel
chiseler	chisel
chiseller	chisel
choice	choose
chosen	choose
choiceness	choose
choir	choir
choke	choke
choker	choke
choking	choke
chomp	chomp
chomping	chomp
chop	chop
chord	chord
chorus	chorus
chrome	chrome
chronicle	chronicle
chronicler	chronicle
chuck	chuck
chuckle	chuckle
chum	chum
chunk	chunk
church	church
churchman	church
cinch	cinch
cinder	cinder
cipher	cipher
circle	circle
circular	circle
circularity	circle
circularisation	circle
circularization	circle
circuit	circuit
circulant	circulate
circulation	circulate
circumvent	circumvent
circumvention	circumvent
citation	cite
cladding	clad
claim	claim
claimant	claim
clam	clam	clamor
clamor	clam	clamor
clamoring	clam	clamor
clang	clang
clanger	clang
clangor	clang
clangoring	clang
clap	clap
clapping	clap
clarification	clarify
clash	clash
class	class
classifier	classify
classification	classify
clatter	clatter
claw	claw
clay	clay
clean	clean
cleaner	clean
cleaning	clean
cleaners	clean
cleanness	clean
cleanliness	clean
clear	clear
clearing	clear
clearance	clear
clearness	clear
cleat	cleat
clench	clench
clerk	clerk
clerking	clerk
clerkship	clerk
click	click
climax	climax
climb	climb
climber	climb
climbing	climb
clinch	clinch
clincher	clinch
cling	cling
clip	clip
clipping	clip
cloak	cloak
clobber	clobber
clock	clock
clocks	clock
clocking	clock
clog	clog
clone	clone
close	close	closure	cloture
closing	close	closure	cloture
closure	close	closure	cloture
cloture	close	closure	cloture
closeness	close	closure	cloture
closet	closet
clot	clot
clotting	clot
cloth	clothe
clothes	clothe
clothing	clothe
cloud	cloud	clouded
clouding	cloud	clouded
clout	clout
clown	clown
clownery	clown
clowning	clown
club	club
clubbing	club
cluck	cluck
clue	clue
clump	clump
cluster	cluster
clutch	clutch
clutches	clutch
co-star	co-star
coach	coach
coaching	coach
coachman	coach
coal	coal
coalman	coal
coalescence	coalesce
coalescency	coalesce
coast	coast
coaster	coast
coat	coat
coatee	coat
coating	coat
coax	coax
coaxing	coax
cock	cock
cocker	cock
cocoon	cocoon
cod	cod
code	code
coding	code
coercion	coerce
coexistence	coexist
coffin	coffin
cohesion	cohere
coherence	cohere
coherency	cohere
cohesiveness	cohere
coiffure	coiffure
coil	coil
coin	coin
coiner	coin
coinage	coin
coincidence	coincide
coke	coke
collaborator	collaborate
collaboration	collaborate
collapse	collapse
collar	collar
collect	collect
collector	collect
collecting	collect
collection	collect
collective	collect
color	color
colors	color
colored	color
coloring	color
coloration	color
colour	colour
colours	colour
colouring	colour
comb	comb
combing	comb
combativeness	comb
combat	combat
combatant	combat
combine	combine
combining	combine
combinator	combine
combination	combine
comer	come
coming	come
comfort	comfort	comfortable
comforts	comfort	comfortable
comforter	comfort	comfortable
comfortableness	comfort	comfortable
command	command
commander	command
commandant	command
commandeer	command
commandment	command
commemoration	commemorate
commencement	commence
commendation	commend
comment	comment
commentary	comment
commentator	comment
commentation	comment
commercial	commercialize
commercialism	commercialize
commercialisation	commercialize
commercialization	commercialize
commiseration	commiserate
committal	commit	commission
commission	commit	commission
commitment	commit	commission
commissioner	commit	commission
commissioning	commit	commission
commune	commune
communion	commune
community	commune
communalisation	commune
communalization	commune
communist	communize
communism	communize
communisation	communize
communization	communize
communicant	communicate
communicator	communicate
communication	communicate
communicating	communicate
communicativeness	communicate
commuter	commute
commuting	commute
commutator	commute
commutation	commute
commutability	commute
compact	compact
compaction	compact
compactness	compact
companion	companion
companionship	companion
companionability	companion
companionableness	companion
company	company
compare	compare
comparing	compare
comparator	compare
comparison	compare
comparative	compare
comparability	compare
compass	compass	compassionate
compassion	compass	compassionate
compassionateness	compass	compassionate
compulsion	compel
compulsive	compel
compulsivity	compel
compulsiveness	compel
compensation	compensate
competence	compete
competency	compete
competition	compete
competitiveness	compete
compiler	compile
compiling	compile
compilation	compile
complaint	complain
complainer	complain
complainant	complain
complement	complement
complementation	complement
completion	complete
completeness	complete
complexion	complexion
complicity	complicate
complicating	complicate
complication	complicate
compliment	compliment
compliments	compliment
compliance	comply
compliancy	comply
comportment	comport
composer	compose
composure	compose
composing	compose
composite	compose
composition	compose
compost	compost
compound	compound
compounding	compound
comprehension	comprehend
comprehensibility	comprehend
comprehensiveness	comprehend
compress	compress
compressor	compress
compressing	compress
compression	compress
compressibility	compress
comprisal	comprise
comprising	comprise
compromise	compromise
computer	compute
computation	compute
con	con
concealing	conceal
concealment	conceal
conceding	concede
concession	concede
concentrate	concentrate
concentration	concentrate
concentricity	concentrate
concept	conceive
conceiver	conceive
conception	conceive
conceivability	conceive
conceivableness	conceive
concert	concert
concertina	concertina
conciliator	conciliate
conciliation	conciliate
conclusion	conclude
conclusiveness	conclude
concrete	concrete
concretion	concrete
concretism	concrete
concreteness	concrete
concretisation	concrete
concretization	concrete
concern	concern
concurrence	concur
condemnation	condemn
condenser	condense	condensate
condensate	condense	condensate
condensing	condense	condensate
condensation	condense	condensate
condition	condition
conditioner	condition
conditioning	condition
conditionality	condition
conduct	conduct
conductor	conduct
conduction	conduct
conducting	conduct
conductance	conduct
conductivity	conduct
cone	cone
conferee	confer
conferral	confer
conference	confer
conferment	confer
confessor	confess
confession	confess
confidant	confide
confidence	confide
confidentiality	confide
confines	confine
confinement	confine
confirmation	confirm
conflict	conflict
confliction	conflict
conformism	conform
conformist	conform
conformity	conform
conformance	conform
conformation	conform
confronting	confront
confrontment	confront
confrontation	confront
confusion	confuse
conglomerate	conglomerate
conglomeration	conglomerate
congratulation	congratulate
congratulations	congratulate
congregating	congregate
congregation	congregate
conjecture	conjecture
conjugate	conjugate
conjugation	conjugate
conjurer	conjure
conjuror	conjure
conjuring	conjure
conjuration	conjure
connecter	connect
connector	connect
connection	connect
connecting	connect
connective	connect
connotation	connote
conquest	conquer
conqueror	conquer
conquering	conquer
conscript	conscript
conscription	conscript
consent	consent
consensus	consent
conserve	conserve
conserves	conserve
conserving	conserve
conservancy	conserve
conservator	conserve
conservation	conserve
conservative	conserve
consideration	consider
considerateness	consider
consignee	consign
consigner	consign
consignor	consign
consignment	consign
consignation	consign
consistence	consist
consistency	consist
consolidation	consolidate
conspiracy	conspire
conspirator	conspire
consitution	constitute
constitution	constitute
constitutional	constitute
constraint	constrain
construct	construct	structure
structure	construct	structure
constructor	construct	structure
construction	construct	structure
structuralism	construct	structure
constructiveness	construct	structure
structuralization	construct	structure
construal	construe
consultant	consult
consultation	consult
consumer	consume
consumption	consume
consumptive	consume
consummation	consummate
contact	contact
contacting	contact
container	contain
containment	contain
containerful	contain
contaminant	contaminate
contamination	contaminate
contemp	contempt
contempt	contempt
contemptibility	contempt
contemplation	contemplate
contemplativeness	contemplate
content	contend	content
contents	contend	content
contender	contend	content
contention	contend	content
contentment	contend	content
contentiousness	contend	content
contest	contest
contestant	contest
contestation	contest
continuant	continue
continuity	continue
continuance	continue
continuation	continue
continuousness	continue
contour	contour
contraband	contraband
contract	contract
contractor	contract
contraction	contract
contracting	contract
contradiction	contradict
contrast	contrast
contravention	contravene
contributor	contribute
contribution	contribute
contriver	contrive
contrivance	contrive
control	control
controller	control
controlling	control
convent	convene
convener	convene
convening	convene
convention	convene
convenience	convenience
conveniences	convenience
converging	converge
convergence	converge
convergency	converge
convert	convert
converter	convert
convertor	convert
conversion	convert
converting	convert
convertible	convert
convertibility	convert
converse	converse
conversance	converse
conversancy	converse
conversation	converse
conveyer	convey
conveyor	convey
conveying	convey
conveyance	convey
convict	convict	convince
conviction	convict	convince
convincing	convict	convince
convincement	convict	convince
convoy	convoy
cook	cook
cooker	cook
cookery	cook
cooking	cook
cool	cool
cooler	cool
coolant	cool
cooling	cool
coolness	cool
coop	coop
cooper	cooperate	co-operate
cooperage	cooperate	co-operate
cooperator	cooperate	co-operate
cooperation	cooperate	co-operate
cooperative	cooperate	co-operate
cooperativeness	cooperate	co-operate
coordinate	coordinate	co-ordinate
coordinator	coordinate	co-ordinate
coordination	coordinate	co-ordinate
cop	cop
cope	cope
copal	cope
coping	cope
copper	copper
copy	copy
copier	copy
copying	copy
copyist	copy
copyright	copyright
coquette	coquette
cord	cord
cords	cord
cording	cord
cordite	cord
cordon	cordon
corduroy	corduroy
corduroys	corduroy
core	core
coral	core
cork	cork
corker	cork
corkscrew	corkscrew
corn	corn
corner	corner
corral	corral
correcting	correct
correction	correct
corrective	correct
correctness	correct
correctitude	correct
correlate	correlate
correlation	correlate
correlative	correlate
correlativity	correlate
correspondent	correspond
correspondence	correspond
corroboration	corroborate
corroding	corrode
corrosion	corrode
corrosive	corrode
corruption	corrupt
corruptness	corrupt
corruptibility	corrupt
cost	cost
costs	cost
costing	cost
costume	costume
cotton	cotton
couch	couch
cough	cough
coughing	cough
counsel	counsel
counselor	counsel
counseling	counsel
count	count	counter
counter	count	counter
counting	count	counter
counterman	count	counter
countenance	countenance
counteraction	counteract
counterattack	counterattack
counterbalance	counterbalance
counterclaim	counterclaim
counterfeit	counterfeit
counterfeiter	counterfeit
counterpoint	counterpoint
country	country
coup	coup
coupe	coup
couple	couple
coupler	couple
coupling	couple
course	course
courser	course
coursing	course
court	court
courting	court
courtship	court
coven	covenant
covenant	covenant
cover	cover
covering	cover
covet	covet
covetousness	covet
cow	cow
cows	cow
cowman	cow
coward	coward
cowhide	cowhide
crack	crack
cracker	crack
cracking	crack
crackle	crackle
crackling	crackle
cracklings	crackle
cradle	cradle
craft	craft
crafter	craft
cramp	cramp
crane	crane
crank	crank
crap	crap
craps	crap
crash	crash
crasher	crash
crate	crate	crater
crater	crate	crater
crateful	crate	crater
craving	crave
crawl	crawl
crawler	crawl
crawling	crawl
craze	craze
creak	creak
creaking	creak
cream	cream
creamer	cream
crease	crease
creator	create
creation	create
creationism	create
credit	credit
creditor	credit
crediting	credit
creep	creep
creeps	creep
creeper	creep
creeping	creep
cremation	cremate
crepe	crepe
crescendo	crescendo
crest	crest
crew	crew
crewman	crew
crib	crib
cricket	cricket
cricketer	cricket
crimson	crimson
cripple	cripple
crisp	crisp
crispness	crisp
critic	critique	criticize
critique	critique	criticize
criticism	critique	criticize
criticality	critique	criticize
criticalness	critique	criticize
croak	croak
croaker	croak
croaking	croak
crochet	crochet
crocheting	crochet
crook	crook
crop	crop
cross	cross
crosse	cross
crossing	cross
crossness	cross
crouch	crouch
crow	crow
crowing	crow
crowd	crowd
crowding	crowd
crown	crown
cruise	cruise
cruiser	cruise
crunch	crunch
crusade	crusade
crusader	crusade
crush	crush
crusher	crush
crushing	crush
crust	crust
cry	cry
crier	cry
crying	cry
crystal	crystallize
crystalization	crystallize
crystallization	crystallize
cube	cube
cubism	cube
cubist	cube
cuff	cuff
cuffs	cuff
culmination	culminate
cultivator	cultivate
cultivation	cultivate
culture	culture
cumulation	cumulate
cup	cup
cupful	cup
cupping	cup
curb	curb
curbing	curb
cure	cure
curl	curl
curler	curl
curling	curl
curry	curry
curse	curse
cursor	curse
curtailment	curtail
curtain	curtain
curve	curve
curvature	curve
cushion	cushion
cushioning	cushion
cut	cut
cutting	cut
cycle	cycle
cycling	cycle
cyclist	cycle
cyclicity	cycle
dam	dam
damage	damage
damages	damage
damn	damn
damned	damn
damnation	damn
damp	damp
damper	damp
dampness	damp
dampening	dampen
dance	dance
dancer	dance
dancing	dance
dangle	dangle
dangling	dangle
dare	dare
daring	dare
darn	darn
darning	darn
dart	dart
darts	dart
darter	dart
dash	dash
date	date
dauntlessness	daunt
dawn	dawn
dawning	dawn
dazzle	dazzle
de-iodination	de-iodinate
deaf	deaf
deafness	deaf
deal	deal
dealer	deal
dealing	deal
dealings	deal
debate	debate
debater	debate
debit	debit
debut	debut
decay	decay
deceit	deceive
deceiver	deceive
deception	deceive
deceitfulness	deceive
deceptiveness	deceive
deceleration	decelerate
december	december
deciding	decide
decision	decide
decisiveness	decide
deck	deck
decking	deck
declarator	declare
declaration	declare
declarative	declare
decline	decline
declination	decline
decomposition	decompose
decontrol	decontrol
decor	decorate
decorator	decorate
decoration	decorate
decorousness	decorate
decorativeness	decorate
decrease	decrease
decree	decree	decrement
decrement	decree	decrement
decry	decry
decrial	decry
dedication	dedicate
deduction	deduce	deduct
deductible	deduce	deduct
deed	deed
deeds	deed
deepening	deepen
default	default
defaulter	default
defeat	defeat
defeated	defeat
defeature	defeat
defeatism	defeat
defeatist	defeat
defeasance	defeat
defect	defect
defector	defect
defection	defect
defectiveness	defect
defense	defend
defender	defend
defendant	defend
defensive	defend
defensibility	defend
deference	defer
deferment	defer
defining	define
definition	define
definiteness	define
deflector	deflect
deflection	deflect
defraudment	defraud
defraudation	defraud
defrayal	defray
defrayment	defray
defusing	defuse
defiance	defy
degenerate	degenerate
degeneration	degenerate
degrade	degrade
degradation	degrade
dehumanisation	dehumanize
dehumanization	dehumanize
delay	delay
delegate	delegate
delegating	delegate
delegation	delegate
deliberation	deliberate
deliberateness	deliberate
delight	delight
delimit	delimit
delimitation	delimit
deliver	deliver
delivery	deliver
deliverer	deliver
deliverance	deliver
delusion	delude
deluge	deluge
demand	demand
demander	demand
demise	demise
democrat	democratize
democratisation	democratize
democratization	democratize
demonstrator	demonstrate
demonstration	demonstrate
demonstrative	demonstrate
demonstrability	demonstrate
demonstrativeness	demonstrate
demoralisation	demoralize
demoralization	demoralize
demythologisation	demythologize
demythologization	demythologize
denote	denote
denotation	denote
denotement	denote
denouncement	denounce
denunciation	denounce
dent	dent
dentist	dent
denial	deny
denier	deny
departed	depart
departer	depart
departure	depart
department	depart
dependant	depend
dependent	depend
dependance	depend
dependence	depend
dependency	depend
dependability	depend
dependableness	depend
depicting	depict
depiction	depict
depletion	deplete
deployment	deploy
deportee	deport
deportment	deport
deportation	deport
depose	depose	deposit
deposal	depose	deposit
deposit	depose	deposit
depositor	depose	deposit
deposition	depose	deposit
depreciator	depreciate
depreciation	depreciate
depress	depress
depressor	depress
depressant	depress
depression	depress
depressive	depress
deprivation	deprive
derailment	derail
deregulating	deregulate
deregulation	deregulate
derivate	derive
deriving	derive
derivation	derive
derivative	derive
derogation	derogate
descent	descend
descendant	descend
descendent	descend
descendants	descend
description	describe
desegregation	desegregate
desert	desert
deserter	desert
desertion	desert
design	design	designate
designer	design	designate
designate	design	designate
designing	design	designate
designation	design	designate
desire	desire
desirability	desire
desirableness	desire
desolation	desolate
despair	despair
desperate	despair
desperation	despair
despatch	despatch
despite	despise
despisal	despise
despising	despise
despicability	despise
despicableness	despise
despot	despot
despotism	despot
destroyer	destroy	destruct
destruction	destroy	destruct
destructibility	destroy	destruct
destructiveness	destroy	destruct
detachment	detach
detail	detail
details	detail
detailing	detail
detent	detain
detente	detain
detainee	detain
detention	detain
detector	detect
detecting	detect
detection	detect
detective	detect
determent	deter
deterrent	deter
deterrence	deter
deterioration	deteriorate
determiner	determine	determinate
determinant	determine	determinate
determinism	determine	determinate
determinist	determine	determinate
determination	determine	determinate
determinative	determine	determinate
determinateness	determine	determinate
detestation	detest
detraction	detract
detribalisation	detribalize
detribalization	detribalize
devaluation	devalue
devastation	devastate
developer	develop
developing	develop
development	develop
divest	divest
divesture	divest
divestment	divest
divestiture	divest
deviant	deviate
deviate	deviate
deviance	deviate
deviancy	deviate
deviation	deviate
device	devise
devise	devise
devisal	devise
devices	devise
devisee	devise
deviser	devise
devising	devise
devil	devil
devilment	devil
devotion	devote
devotement	devote
devourer	devour
diagnosis	diagnose
diagnosing	diagnose
diagnostic	diagnose
diagnostics	diagnose
diagram	diagram
diagramming	diagram
dial	dial
dialogue	dialogue
dice	dice
diction	dice
dictate	dictate
dication	dictate
dictator	dictate
dictation	dictate
diet	diet
dietary	diet
dieting	diet
dietetics	diet
difference	differ	differentiate
differential	differ	differentiate
differentiator	differ	differentiate
differentiation	differ	differentiate
diffusor	diffuse
diffuser	diffuse
diffusion	diffuse
diffuseness	diffuse
dig	dig
digs	dig
digging	dig
diggings	dig
digest	digest
digester	digest
digestion	digest
digestibility	digest
digestibleness	digest
dignification	dignify
digression	digress
dilation	dilate
dilatation	dilate
dilute	dilute
dilutant	dilute
diluting	dilute
dilution	dilute
dimer	dim
dimness	dim
dimension	dimension
diminution	diminish
diminutive	diminish
diminishment	diminish
diminutiveness	diminish
din	din	dine
diner	din	dine
dining	din	dine
dip	dip
director	direct
direction	direct
directive	direct
directness	direct
directivity	direct
directorate	direct
dirtying	dirty
dirtiness	dirty
disable	disable
disabled	disable
disability	disable
disablement	disable
disabuse	disabuse
disabusal	disabuse
disadvantage	disadvantage
disaffiliation	disaffiliate
disagreement	disagree
disagreeableness	disagree
disallowance	disallow
disappearing	disappear
disappearance	disappear
disapproval	disapprove
disarmer	disarm
disarming	disarm
disarmament	disarm
disarray	disarray
disassembly	disassemble
disbelief	disbelieve
disbeliever	disbelieve
discard	discard
discarding	discard
discernment	discern
discernability	discern
discharge	discharge
discipline	discipline
disclosure	disclose
disconcert	disconcert
disconcertion	disconcert
disconcertment	disconcert
discontent	discontent
discontentment	discontent
discontinuity	discontinue
discontinuance	discontinue
discontinuation	discontinue
discord	discord
discordant	discord
discordance	discord
discount	discount
discourage	discourage
discouragement	discourage
discourse	discourse
discover	discover
discovery	discover
discoverer	discover
discredit	discredit
discriminant	discriminate
discriminator	discriminate
discrimination	discriminate
discussant	discuss
discussion	discuss
disdain	disdain
disdainment	disdain
disdainfulness	disdain
disengagement	disengage
disentanglement	disentangle
disfavor	disfavor
disgorgement	disgorge
disgrace	disgrace
disgracefulness	disgrace
disguise	disguise
disgust	disgust
dish	dish
dishful	dish
disheartenment	dishearten
dishonor	dishonor
dishonorableness	dishonor
disintegration	disintegrate
disinterest	disinterest
disk	disk
dislike	dislike
dislodgment	dislodge
dislodgement	dislodge
dismantle	dismantle
dismantling	dismantle
dismantlement	dismantle
dismay	dismay
dismember	dismember
dismemberment	dismember
dismiss	dismiss
dismissal	dismiss
dismission	dismiss
disorder	disorder
disowning	disown
disownment	disown
dispatch	dispatch
dispatcher	dispatch
dispenser	dispense
dispensing	dispense
dispensation	dispense
dispensability	dispense
dispensableness	dispense
dispersal	disperse
dispersion	disperse
displacement	displace
display	display
dispose	dispose
disposal	dispose
disposure	dispose
disposition	dispose
disproof	disprove
disproval	disprove
disproving	disprove
dispute	dispute
disputant	dispute
disputation	dispute
disqualifying	disqualify
disqualification	disqualify
disquiet	disquiet
disregard	disregard
disrepair	disrepair
disrespect	disrespect
disrobement	disrobe
disruption	disrupt
dissent	dissent
dissenter	dissent
dissident	dissent
dissension	dissent
dissidence	dissent
dissolve	dissolve
dissolver	dissolve
dissolvent	dissolve
dissolution	dissolve
dissolubility	dissolve
dissoluteness	dissolve
dissuasion	dissuade
distance	distance
distill	distil
distiller	distil
distillate	distil
distillment	distil
distillation	distil
distinction	distinguish
distinctness	distinguish
distinctiveness	distinguish
distort	distort
distortion	distort
distract	distract
distraction	distract
distress	distress
distressfulness	distress
distribute	distribute
distributer	distribute
distributor	distribute
distribution	distribute
district	district
distrust	distrust
distrustfulness	distrust
disturbance	disturb
ditch	ditch
dive	dive
diver	dive
diving	dive
diversification	diversify
diverse	divert	diverse
diversion	divert	diverse
diversity	divert	diverse
diverseness	divert	diverse
divide	divide
divider	divide
dividers	divide
division	divide
divisibility	divide
divine	divine
diviner	divine
divinity	divine
divination	divine
divinisation	divine
divinization	divine
divorce	divorce
divorcee	divorce
divorcement	divorce
divulsion	divulge
divulgence	divulge
divulgation	divulge
divulgement	divulge
dizziness	dizzy
do	do	don
don	do	don
dos	do	don
doer	do	don
door	do	don
doing	do	don
donee	do	don
dock	dock
docker	dock
dockage	dock
docking	dock
doctor	doctor
doctorate	doctor
document	document
documentation	document
dodge	dodge
dodger	dodge
dodging	dodge
dog	dog
dole	dole
dolefulness	dole
doll	doll
domicile	domicile
domine	dominate
dominant	dominate
dominance	dominate
domination	dominate
donation	donate
dong	dong
doom	doom
doomed	doom
dope	dope
dose	dose
dot	dot
double	double
doubles	double
doubling	double
doubt	doubt
doubter	doubt
doubtfulness	doubt
dovetail	dovetail
dower	dower
down	down
downer	down
downgrade	downgrade
downsizing	downsize
draft	draft
draftee	draft
drafter	draft
drafting	draft
drag	drag
dragee	drag
drain	drain
drainage	drain
drama	dramatize
dramatist	dramatize
dramatics	dramatize
dramatization	dramatize
dramatisation	dramatise
draught	draught
draughts	draught
draw	draw
drawee	draw
drawer	draw
drawers	draw
drawing	draw
drawl	drawl
drawler	drawl
dread	dread
dreadfulness	dread
dream	dream
dreamer	dream
dreaming	dream
dredge	dredge
dredger	dredge
dress	dress
dresser	dress
dressing	dress
dribble	dribble
dribbler	dribble
dribbling	dribble
drift	drift
drifter	drift
drifting	drift
drill	drill
drilling	drill
drink	drink	drunken
drunk	drink	drunken
drinker	drink	drunken
drinking	drink	drunken
drunkenness	drink	drunken
drip	drip
dripping	drip
drippings	drip
drive	drive
driver	drive
driving	drive
drizzle	drizzle
drone	drone
droning	drone
droop	droop
drop	drop
dropping	drop
droppings	drop
drug	drug
drugging	drug
drum	drum
drumming	drum
dry	dry
drier	dry
dryer	dry
dryness	dry
duck	duck
ducking	duck
duel	duel
dueler	duel
duello	duel
duelist	duel
dullness	dull
dummy	dummy
dump	dump
dumps	dump
dumper	dump
dumping	dump
dun	dun
dung	dung
dunk	dunk
dunker	dunk
dunkers	dunk
duplicate	duplicate
duplicity	duplicate
duplicator	duplicate
duplicating	duplicate
duplication	duplicate
duplicability	duplicate
dust	dust
duster	dust
dustman	dust
dwarf	dwarf
dwarfism	dwarf
dweller	dwell
dwelling	dwell
dwindling	dwindle
dy	die	dying
die	die	dying
death	die	dying
dying	die	dying
dyke	dyke
dynamite	dynamite
dynamiter	dynamite
dynamitist	dynamite
eagle	eagle
eaglet	eagle
earmark	earmark
earner	earn
earning	earn
earnings	earn
earth	earth
earthing	earth
earthman	earth
ease	ease
easing	ease
easement	ease
eats	eat
eater	eat
eating	eat
edible	eat
edibility	eat
edibleness	eat
ebb	ebb
echo	echo
eclipse	eclipse
ecliptic	eclipse
economist	economize
economics	economize
economiser	economize
economizer	economize
economisation	economize
economization	economize
edge	edge
edger	edge
edging	edge
edginess	edge
editor	edit
editing	edit
edition	edit
educatee	educate
eduction	educate
educator	educate
education	educate
effect	effect
effects	effect
effector	effect
effectivity	effect
effectiveness	effect
effectuality	effectuate
effectuation	effectuate
effectualness	effectuate
effeminacy	effeminate
effeminateness	effeminate
efflorescence	effloresce
egg	egg
eggs	egg
ejector	eject
ejection	eject
elaboration	elaborate
elaborateness	elaborate
elbow	elbow
elbowing	elbow
elect	elect
elector	elect
election	elect
electress	elect
electorate	elect
elicitation	elicit
elimination	eliminate
emancipator	emancipate
emancipation	emancipate
embargo	embargo
embarkment	embark
embarkation	embark
embezzler	embezzle
embezzlement	embezzle
embodiment	embody
embrace	embrace
embracing	embrace
embracement	embrace
emersion	emerge
emergence	emerge
emergency	emerge
emission	emit
emphasis	emphasize
emphasizing	emphasize
employ	employ
employee	employ
employer	employ
employment	employ
empowerment	empower
empty	empty
emptying	empty
emptiness	empty
emulation	emulate
emulsion	emulsion
enablement	enable
enactment	enact
enamel	enamel
encampment	encamp
enchanter	enchant
enchantment	enchant
enchantress	enchant
encirclement	encircle
encompassment	encompass
encounter	encounter
encouragement	encourage
encroacher	encroach
encroachment	encroach
end	end
ending	end
endangerment	endanger
endeavor	endeavor
endeavour	endeavour
endorser	endorse
endorsement	endorse
endowment	endow
endurance	endure
enforcer	enforce
enforcement	enforce
engagement	engage
engenderment	engender
engine	engineer
engineer	engineer
engineering	engineer
enhancement	enhance
enjoining	enjoin
enjoinment	enjoin
enjoyer	enjoy
enjoyment	enjoy
enjoyableness	enjoy
enlarger	enlarge
enlargement	enlarge
enlistee	enlist
enlisting	enlist
enlistment	enlist
enmity	enmity
enquiry	enquire
enquirer	enquire
enragement	enrage
enrichment	enrich
enrolment	enroll
enrollment	enroll
enslaving	enslave
enslavement	enslave
entail	entail
entailment	entail
entry	enter	entrance
entrant	enter	entrance
ingress	enter	entrance
entrance	enter	entrance
enterics	enter	entrance
entering	enter	entrance
enteritis	enter	entrance
ingression	enter	entrance
entrancement	enter	entrance
entertainer	entertain
entertainment	entertain
enticement	entice
entitlement	entitle
entreaty	entreat
entreatment	entreat
intreatment	entreat
entrustment	entrust
intrustment	entrust
enunciation	enunciate
envelope	envelope
enveloping	envelope
envelopment	envelope
envisagement	envisage
envisioning	envision
envy	envy
epitome	epitomize
epitomization	epitomize
epoxy	epoxy
equal	equal	equalize
equality	equal	equalize
equaliser	equal	equalize
equalizer	equal	equalize
equalisation	equal	equalize
equalization	equal	equalize
equator	equate
equating	equate
equation	equate
equatability	equate
equipment	equip
equipping	equip
eradicator	eradicate
eradication	eradicate
eraser	erase
erasure	erase
erecting	erect
erection	erect
erectness	erect
eroding	erode
erosion	erode
error	err
erratum	err
eruption	erupt
escalator	escalate
escalation	escalate
escape	escape
escapee	escape
escapade	escape
escapism	escape
escapist	escape
escapement	escape
escheat	escheat
escheatage	escheat
eschewal	eschew
escort	escort
essay	essay
essayist	essay
establishment	establish
esteem	esteem
estimate	estimate
estimator	estimate
estimation	estimate
eulogy	eulogize
eulogist	eulogize
eulogization	eulogize
evacuee	evacuate
evacuation	evacuate
evasion	evade
evasiveness	evade
evaluator	evaluate
evaluation	evaluate
evaporation	evaporate
evening	even
evenness	even
eventuality	eventuate
eventuation	eventuate
evidence	evidence
evocation	evoke
evolution	evolve
evolvement	evolve
exacerbation	exacerbate
exact	exact
exaction	exact
exactness	exact
exactitude	exact
exaggeration	exaggerate
exaltation	exalt
examine	examine
examinee	examine
examiner	examine
examination	examine
example	example
exasperation	exasperate
excess	exceed
excessiveness	exceed
excellency	excel
excellence	excel
exception	except
excerpt	excerpt
excerption	excerpt
exchange	exchange
exchanger	exchange
exchangeability	exchange
excise	excise
excision	excise
exciseman	excise
excitation	excite
excitement	excite
excitability	excite
excitableness	excite
exclaim	exclaim
exclaiming	exclaim
exclamation	exclaim
exclusion	exclude
exclusive	exclude
exclusiveness	exclude
excoriation	excoriate
excuse	excuse
executor	execute
executant	execute
execution	execute
executing	execute
executive	execute
executioner	execute
exemplification	exemplify
exemption	exempt
exercise	exercise
exerciser	exercise
exercising	exercise
exercitation	exercise
exertion	exert
exhaust	exhaust
exhaustion	exhaust
exhibit	exhibit
exhibitor	exhibit
exhibition	exhibit
exile	exile
existence	exist	existing
existentialism	exist	existing
exit	exit
exoneration	exonerate
exorcism	exorcise
exorcist	exorcise
exorciser	exorcise
expanse	expand
expansion	expand
expansivity	expand
expansiveness	expand
expatriate	expatriate
expatriation	expatriate
expectancy	expect
expectation	expect
expedient	expedite	expedient
expediency	expedite	expedient
expedience	expedite	expedient
expedition	expedite	expedient
expeditiousness	expedite	expedient
expelling	expel
expulsion	expel
expense	expend
expender	expend
expending	expend
expenditure	expend
expensiveness	expend
experience	experience	experiment
experiment	experience	experiment
experimenter	experience	experiment
experimentalism	experience	experiment
experimentation	experience	experiment
expiry	expire
expiration	expire
explain	explain
explanation	explain
explosion	explode
explosive	explode
exploit	exploit
exploiter	exploit
exploitation	exploit
explorer	explore
exploration	explore
export	export
exporter	export
exporting	export
exportation	export
expose	expose
exposure	expose
exposition	expose
express	express
expression	express
expressiveness	express
expunging	expunge
expunction	expunge
extemporisation	extemporize
extemporization	extemporize
extension	extend
extensibility	extend
extent	extent
extenuation	extenuate
exterminator	exterminate
extermination	exterminate
extinction	extinct
extinguisher	extinguish
extinguishing	extinguish
extinguishment	extinguish
extract	extract
extractor	extract
extraction	extract
extrapolation	extrapolate
extrication	extricate
eye	eye
eyes	eye
eyeful	eye
eyeball	eyeball
fabric	fabricate
fabricator	fabricate
fabrication	fabricate
face	face
facer	face
facing	face
faction	face
facilitator	facilitate
facilitation	facilitate
facsimile	facsimile
factor	factor
factoring	factor
factorisation	factor
factorization	factor
fade-in	fade-in
fade	fade
fading	fade
failing	fail
failure	fail
faint	faint
faintness	faint
fair	fair
fairness	fair
fake	fake
faker	fake
fakeer	fake
falcon	falcon
falconer	falcon
falconry	falcon
fall	fall
falls	fall
fallal	fall
falling	fall
falsifier	falsify
falsifying	falsify
falsification	falsify
falter	falter
faltering	falter
fame	fame
fan	fan
fanion	fan
fancy	fancy
fancier	fancy
fare	fare
farness	fare
farm	farm
farmer	farm
farming	farm
fascination	fascinate
fashion	fashion
fashions	fashion
fashioning	fashion
fast	fast
fasting	fast
fastness	fast
fastener	fasten
fastening	fasten
fat	fat
fatness	fat
fate	fate
fates	fate
father	father
fathom	fathom
fatigue	fatigue
fatigues	fatigue
fault	fault
favor	favor
favorableness	favor
favour	favour
favourite	favour
favouritism	favour
favourableness	favour
fawn	fawn
fear	fear
fearfulness	fear
feast	feast
feasting	feast
feather	feather
feathering	feather
feature	feature
federal	federalize
federalism	federalize
federation	federalize
federalisation	federalize
federalization	federalize
fee	fee
feed	feed
feeder	feed
feeding	feed
feel	feel
feeler	feel
feeling	feel
feelings	feel
feint	feint
fell	fell
fellation	fell
felt	felt
fence	fence
fencer	fence
fencing	fence
fender	fend
ferment	ferment
fermenting	ferment
fermentation	ferment
ferret	ferret
ferry	ferry
ferris	ferry
ferrying	ferry
ferryman	ferry
fetch	fetch
fete	fete
fetor	fete
feud	feud
fever	fever
fiddle	fiddle
fiddler	fiddle
field	field
fielder	field
fielding	field
fight	fight
fighter	fight
fighting	fight
figure	figure
figurer	figure
figuring	figure
figuration	figure
file	file
filer	file
filing	file
filibuster	filibuster
filibusterer	filibuster
fill	fill
fille	fill
filler	fill
filling	fill
fillip	fillip
film	film
filming	film
filmmaker	film
filmmaking	film
filter	filter
filtrate	filter
filtration	filter
fin	fin
fins	fin
finance	finance	financier
finances	finance	financier
financier	finance	financier
financing	finance	financier
find	find
finder	find
finding	find
fine	fine	finalize
final	fine	finalize
finale	fine	finalize
fining	fine	finalize
finality	fine	finalize
finalist	fine	finalize
fineness	fine	finalize
finalization	fine	finalize
finger	finger
fingering	finger
fingerprint	fingerprint
fingerprinting	fingerprint
finish	finish
finisher	finish
finishing	finish
fire	fire
first	fire
firing	fire
fireman	fire
fieriness	fire
firm	firm
firmness	firm
fish	fish
fisher	fish
fishery	fish
fishing	fish
fit	fit
fitment	fit
fitness	fit
fitting	fit
fitfulness	fit
fix	fix
fixer	fix
fixing	fix
fixings	fix
fixture	fix
fixation	fix
fixative	fix
fizz	fizz
flag	flag
flagship	flag
flail	flail
flame	flame
flaming	flame
flammability	flame
flank	flank
flannel	flannel
flannels	flannel
flare	flare
flash	flash
flasher	flash
flashing	flash
flattery	flatter
flatterer	flatter
flavor	flavor	flavour
flavour	flavor	flavour
flavorer	flavor	flavour
flavoring	flavor	flavour
flavourer	flavor	flavour
flavouring	flavor	flavour
flaw	flaw
fleck	fleck
fleet	fleet
fleetness	fleet
flesh	flesh
flex	flex
flexor	flex
flexion	flex
flection	flex
flick	flick	flicker
flicker	flick	flicker
fling	fling
flip	flip
flirt	flirt
flirting	flirt
flirtation	flirt
float	float
floater	float
flotation	float
floatation	float
flock	flock
flogging	flog
flood	flood
flooding	flood
floodlight	floodlight
floor	floor
flooring	floor
flop	flop
flopping	flop
flounder	flounder
flour	flour
flourish	flourish
flow	flow
flowing	flow
flower	flower
florist	flower
flowering	flower
fluctuation	fluctuate
fluff	fluff
flurry	flurry
flush	flush
flute	flute
fluting	flute
flutist	flute
flautist	flute
flutter	flutter
fluttering	flutter
flux	flux
fly	fly	flee	flight
flier	fly	flee	flight
flyer	fly	flee	flight
flight	fly	flee	flight
flying	fly	flee	flight
foal	foal
foam	foam
fob	fob
focus	focus
fodder	fodder
fog	fog
foil	foil
foiling	foil
fold	fold
folder	fold
folding	fold
follower	follow
followers	follow
following	follow
fool	fool
foot	foot
footer	foot
footing	foot
footman	foot
footnote	footnote
forage	forage
foraging	forage
foray	foray
forbidding	forbid
forbiddance	forbid
force	force
forcefulness	force
forearm	forearm
forecast	forecast
forecaster	forecast
forecasting	forecast
foreground	foreground
foregrounding	foreground
foresaw	foresaw
foresight	foresee
foresightfulness	foresee
foreshadowing	foreshadow
forest	forest
forester	forest
forestry	forest
forestalling	forestall
forestalment	forestall
forestallment	forestall
foretelling	foretell
forfeit	forfeit
forfeiture	forfeit
forge	forge
forger	forge
forgery	forge
forging	forge
forgetfulness	forget
forgiveness	forgive	forgiven
forgoing	forgo
fork	fork
forkful	fork
forking	fork
form	form	format
format	form	format
former	form	format
formation	form	format
formative	form	format
formatting	form	format
formal	formalise	formalize
formalism	formalise	formalize
formality	formalise	formalize
formalness	formalise	formalize
formalities	formalise	formalize
formalisation	formalise	formalize
formalization	formalise	formalize
formulation	formulate
formulization	formulate
forsaking	forsake
fort	fort
forte	fort
fortification	fortify
forward	forward
forwarding	forward
forwardness	forward
fosterage	foster
fostering	foster
foul	foul
foulness	foul
found	found	founder
founder	found	founder
founding	found	founder
foundation	found	founder
foundering	found	founder
fowl	fowl
fox	fox
fraction	fraction
fractionation	fraction
fractionisation	fraction
fractionization	fraction
fracture	fracture
fragment	fragment
fragmentation	fragment
frame	frame	frames
framer	frame	frames
framing	frame	frames
franchise	franchise
franchisement	franchise
frank	frank
frankness	frank
fraternity	fraternize
fraternization	fraternize
fray	fray
freak	freak
free	free
freedom	free
freeing	free
freeman	free
freight	freight
freighter	freight
frenzy	frenzy
frequence	frequent
frequency	frequent
frequenter	frequent
frequentation	frequent
fresco	fresco
fret	fret
fretfulness	fret
fright	fright	frighten
frightening	fright	frighten
frightfulness	fright	frighten
fringe	fringe
frock	frock
frolic	frolic
frolicker	frolic
frolicsomeness	frolic
front	front
frontal	front
frontage	front
frost	frost	freeze	freezing
freeze	frost	freeze	freezing
freezer	frost	freeze	freezing
freezing	frost	freeze	freezing
frosting	frost	freeze	freezing
frostbite	frostbite
froth	froth
frown	frown
fruit	fruit
fruition	fruit
fruitfulness	fruit
frustrating	frustrate
frustration	frustrate
fry	fry
frier	fry
fryer	fry
frying	fry
fuck	fuck
fucker	fuck
fucking	fuck
fuel	fuel
fueling	fuel
fulfilment	fulfil	fulfill
fulfillment	fulfil	fulfill
fulness	full
fullness	full
fullback	fullback
fulminate	fulminate
fulmination	fulminate
fumble	fumble
fumbler	fumble
function	function
functionary	function
functioning	function
functionalism	function
fund	fund
funds	fund
funding	fund
funnel	funnel
fur	fur
furor	fur
furore	fur
furring	fur
furlough	furlough
furnishing	furnish
furnishings	furnish
furrow	furrow
furtherance	further
fuse	fuse
fusee	fuse
fusion	fuse
fuss	fuss
ga	gas
gas	gas
gasman	gas
gasification	gas
gab	gab
gabble	gabble
gag	gag
gagman	gag
gage	gage
gaggle	gaggle
gain	gain
gainer	gain
gall	gall	gallant
gallant	gall	gallant
gallantry	gall	gallant
gallop	gallop
gamble	gamble
gambler	gamble
gambling	gamble
game	game
gaming	game
gameness	game
gaminess	game
gander	gander
gang	gang
ganges	gang
gap	gap
garage	garage
garb	garb
garden	garden
gardener	garden
gardening	garden
gargle	gargle
garland	garland
garment	garment
garner	garner
garrison	garrison
garter	garter
gash	gash
gasp	gasp
gate	gate
gather	gather
gatherer	gather
gathering	gather
gauge	gauge
gaze	gaze
gazette	gazette
gazetteer	gazette
gear	gear
gears	gear
gearing	gear
gel	gel
general	general	generalize
generality	general	generalize
generalist	general	generalize
generalization	general	generalize
generator	generate
generation	generate
gentleness	gentle
germ	germinate
germinal	germinate
germination	germinate
gesture	gesture
get-together	get-together
getting	get
ghost	ghost
gibbet	gibbet
gibe	gibe
gift	gift	give
give	gift	give
given	gift	give
giver	gift	give
giving	gift	give
givenness	gift	give
gig	gig
giggle	giggle
gild	gild
gilder	gild
gilding	gild
gin	gin
ginger	ginger
girder	gird
girdle	girdle
girth	girth
glamor	glamorize
glamorisation	glamorize
glamorization	glamorize
glamour	glamour
glance	glance
glare	glare
glass	glass
glasses	glass
glassful	glass
glaze	glaze
glazer	glaze
glazing	glaze
gleam	gleam
gleaming	gleam
gleaner	glean
glide	glide
glider	glide
gliding	glide
glimmer	glimmer
glimmering	glimmer
glimpse	glimpse
glint	glint
glissade	glissade
glisten	glisten
glitter	glitter
glory	glory	glorify
glorification	glory	glorify
gloss	gloss
glove	glove
gloves	glove
glow	glow
glowing	glow
glue	glue
glut	glut
gnaw	gnaw
gnawer	gnaw
go	go
goal	go
goer	go
going	go
goad	goad
goading	goad
gold	gold	golden
gold-mining	gold	golden
golf	golf
golfer	golf
golfing	golf
goose	goose
gosling	goose
gorge	gorge
gossip	gossip
gossiper	gossip
gossiping	gossip
governed	govern
governor	govern
governess	govern
governing	govern
governance	govern
government	govern
gown	gown
grab	grab
grace	grace
graces	grace
gracefulness	grace
grade	grade
grader	grade
grading	grade
gradation	grade
graduate	graduate
graduation	graduate
graffiti	graffiti
grain	grain
graining	grain
granularity	grain
grant	grant
grantee	grant
grantor	grant
graph	graph
graphite	graph
graphitisation	graph
graphitization	graph
grapple	grapple
grappling	grapple
grasp	grasp
grasping	grasp
grass	grass
grate	grate
grater	grate
grating	grate
gratefulness	grate
gratification	gratify
grave	grave
graveness	grave
gravel	gravel
gray	gray
grayness	gray
graze	graze
grazing	graze
grease	grease
greaser	grease
greasiness	grease
green	green
greens	green
greenery	green
greening	green
greenness	green
greeting	greet
grey	grey
greyness	grey
grill	grill
grille	grill
grilling	grill
grimace	grimace
grin	grin
grinning	grin
grind	grind
grinder	grind
grinding	grind
grip	grip
gripe	grip
grit	grit
grits	grit
groan	groan
groin	groin
groom	groom
grooming	groom
groove	groove
groover	groove
grooving	groove
grope	grope
gross	gross
grossness	gross
ground	ground
grounds	ground
grounder	ground
grounding	ground
group	group
grouper	group
grouping	group
groveller	grovel
grower	grow
growth	grow
growing	grow
growl	growl
growler	growl
growling	growl
grub	grub
grudge	grudge
grumble	grumble
grumbler	grumble
grumbling	grumble
grunt	grunt
guarantee	guarantee
guaranty	guaranty
guard	guard
guarding	guard
guess	guess
guessing	guess
guest	guest
gui	guy
guy	guy
guide	guide
guiding	guide
guidance	guide
gull	gull
gulp	gulp
gulping	gulp
gum	gum
gumming	gum
gun	gun
gunnery	gun
gurgle	gurgle
gush	gush
gusher	gush
gust	gust
gut	gut
guts	gut
gutter	gutter
guzzler	guzzle
guzzling	guzzle
habit	habit
habitue	habit
habitation	habit
habituation	habit
habitability	habit
hack	hack
hackee	hack
hacker	hack
haggle	haggle
haggling	haggle
hail	hail
hallmark	hallmark
halt	halt	halter
halter	halt	halter
haltere	halt	halter
ham	ham
hamming	ham
hammer	hammer
hammering	hammer
hamper	hamper
hand	hand
hands	hand
handful	hand
handicap	handicap
handle	handle
handler	handle
handling	handle
hang	hang	hanging
hanger	hang	hanging
hanging	hang	hanging
hangman	hang	hanging
hangar	hangar
happening	happen
harassment	harass
harbor	harbor
harbour	harbour
hardening	harden
hare	hare
harm	harm
harmfulness	harm
harness	harness
harp	harp
harrier	harry
harvest	harvest
harvester	harvest
harvesting	harvest
harvestman	harvest
hash	hash
haste	hasten
hastings	hasten
hastening	hasten
hastiness	hasten
hat	hat
hatful	hat
hatter	hat
hatch	hatch
hatching	hatch
hate	hate
hater	hate
hatefulness	hate
haul	haul
hauler	haul
haulage	haul
hauling	haul
haunt	haunt
have	have
hawk	hawk
hawker	hawk
hawking	hawk
hay	hay
haying	hay
hazard	hazard
hazarding	hazard
hazardousness	hazard
haze	haze
haziness	haze
head	head
header	head
heading	head
headman	head
headful	head
headship	head
headline	headline
headliner	headline
headquarters	headquarter
healer	heal
healing	heal
heap	heap
heaps	heap
hearer	hear
hearing	hear
heat	heat
heater	heat
heating	heat
heave	heave
heaver	heave
heaves	heave
heaving	heave
hector	hector
hedge	hedge
hedging	hedge
heed	heed
heedfulness	heed
heel	heel
helicopter	helicopter
help	help
helper	help
helping	help
helpfulness	help
hem	hem
hemorrhage	hemorrhage
herald	herald
herd	herd
herder	herd
hesitance	hesitate
hesitancy	hesitate
hesitater	hesitate
hesitator	hesitate
hesitation	hesitate
hex	hex
hibachi	hibachi
hibernation	hibernate
hiccup	hiccup
hide	hide
hiding	hide
high	heighten
highness	heighten
highlight	highlight
highlighting	highlight
hike	hike
hiker	hike
hill	hill
hills	hill
hindrance	hinder
hinge	hinge
hint	hint
hire	hire
hirer	hire
hiring	hire
hiss	hiss
hissing	hiss
hit	hit
hitting	hit
hitch	hitch
hive	hive
hives	hive
hoax	hoax
hoaxer	hoax
hob	hob
hobble	hobble
hog	hog
hoist	hoist
hold	hold
holder	hold
holding	hold
hole	hole
holiday	holiday
hollow	hollow
hollowness	hollow
homage	homage
home	home	homer
homer	home	homer
homestead	homestead
homesteader	homestead
homogenate	homogenize
homogeneity	homogenize
homogenisation	homogenize
homogenization	homogenize
homogeneousness	homogenize
hone	honor
honor	honor
honoring	honor
honorific	honor
honorableness	honor
honey	honey
honeycomb	honeycomb
honeymoon	honeymoon
honeymooner	honeymoon
honour	honour
honours	honour
honourableness	honour
hood	hood
hoof	hoof
hoofing	hoof
hook	hook
hooker	hook
hoop	hoop
hoot	hoot
hooter	hoot
hop	hop
hops	hop
hope	hope
hopeful	hope
hopefulness	hope
horn	horn
horse	horse
hose	hose
host	host
hound	hound
house	house
housing	house
houseful	house
houseman	house
housings	house
hover	hover
howl	howl
howler	howl
howling	howl
huckster	huckster
huddle	huddle
hue	hue
hug	hug
hugging	hug
hulk	hulk
hull	hull
hum	hum	humor
humor	hum	humor
humming	hum	humor
humoring	hum	humor
humorousness	hum	humor
human	humanize
humans	humanize
humanist	humanize
humanoid	humanize
humanity	humanize
humanism	humanize
humanness	humanize
humaneness	humanize
humanities	humanize
humanisation	humanize
humanitarian	humanize
humanization	humanize
humanitarianism	humanize
humbling	humble
humbleness	humble
humour	humour
humourist	humour
hunch	hunch
hunger	hunger
hungriness	hunger
hunt	hunt
hunter	hunt
hunting	hunt
hurdle	hurdle
hurdler	hurdle
hurdles	hurdle
hurdling	hurdle
hurl	hurl
hurler	hurl
hurling	hurl
hurry	hurry
hurrying	hurry
hurt	hurt
hurting	hurt
husband	husband
husbandry	husband
husbandman	husband
hush	hush
hustle	hustle
hustler	hustle
hymn	hymn
hymnal	hymn
hypertrophy	hypertrophy
hypothesis	hypothesize
ice	ice
icing	ice
iceman	ice
iciness	ice
identification	identify
idler	idle
idling	idle
idleness	idle
idol	idolize
idolator	idolize
idolatry	idolize
idolisation	idolize
idolization	idolize
igniter	ignite
ignitor	ignite
ignition	ignite
ignorant	ignore
ignorance	ignore
ignorantness	ignore
illuminant	illumine	illuminate
illuminance	illumine	illuminate
illumination	illumine	illuminate
illustrator	illustrate
illustration	illustrate
image	image	imagine
imagery	image	imagine
imagism	image	imagine
imaging	image	imagine
imagination	image	imagine
imaginativeness	image	imagine
imbiber	imbibe
imbibing	imbibe
imbibition	imbibe
imitator	imitate
imitation	imitate
immediacy	immediate
immediateness	immediate
impact	impact
impaction	impact
impair	impair
impairment	impair
impart	impart
imparting	impart
impartment	impart
impartation	impart
impedance	impede
impedence	impede
impediment	impede
impulse	impulse
impeller	impulse
impulsion	impulse
impulsiveness	impulse
imperil	imperil
imperilment	imperil
impinging	impinge
impingement	impinge
implant	implant
implantation	implant
implement	implement
implementation	implement
imploration	implore
implicant	imply	implicate
implicating	imply	implicate
implication	imply	implicate
import	import
importer	import
importing	import
importance	import
importation	import
impose	impose
imposition	impose
impoverishment	impoverish
impovempoverishment	impoverish
impress	impress
impression	impress
impressure	impress
impressment	impress
impressionism	impress
impressiveness	impress
imprint	imprint
imprinting	imprint
improver	improve
improvement	improve
improvisation	improvise
imputation	impute
inactivation	inactivate
inboard	inboard
incarnation	incarnate
incense	incense
incensation	incense
incensement	incense
inch	inch
incisor	incise
incision	incise
incisiveness	incise
inciter	incite
incitation	incite
incitement	incite
incline	incline
inclining	incline
inclination	incline
inclusion	include
income	income
incoming	income
inconvenience	inconvenience
incorporation	incorporate
incorporeality	incorporate
increase	increase
incur	incur
incurable	incur
incurment	incur
incurring	incur
incursion	incur
incurrence	incur
incurability	incur
incurableness	incur
indeed	indeed
indemnification	indemnify
indent	indenture
indenture	indenture
indentation	indenture
index	index
indexer	index
indexing	index
indexation	index
indic	indicate
indicant	indicate
indicator	indicate
indicating	indicate
indication	indicate
indicative	indicate
induct	induce
inductor	induce
inducing	induce
induction	induce
inducement	induce
inductance	induce
indulging	indulge
indulgence	indulge
infant	infancy
infancy	infancy
infantilism	infancy
infarct	infarct
infarction	infarct
infection	infect
inferral	infer
inference	infer
infest	infest
infestation	infest
infield	infield
infielder	infield
infirm	infirm
infirmary	infirm
infirmity	infirm
inflame	inflame
inflaming	inflame
inflammation	inflame
inflater	inflate
inflator	inflate
inflation	inflate
infliction	inflict
inflow	inflow
influence	influence
inform	inform
informer	inform
informant	inform
informing	inform
informality	inform
information	inform
infringe	infringe
infringement	infringe
infuriation	infuriate
infuse	infuse
infusion	infuse
inhabit	inhabit
inhabitant	inhabit
inhabitancy	inhabit
inhabitation	inhabit
inheritor	inherit
inheritance	inherit
inhibitor	inhibit
inhibition	inhibit
initial	initial	initiate
initiate	initial	initiate
initiator	initial	initiate
initiation	initial	initiate
initiative	initial	initiate
initialisation	initial	initiate
initialization	initial	initiate
injectant	inject
injection	inject
injury	injure
injuriousness	injure
ink	ink
inland	inland
inlet	inlet
inmate	inmate
innovator	innovate
innovation	innovate
innovativeness	innovate
input	input
inquest	inquest
inquiry	inquire
inquirer	inquire
inquiring	inquire
inquisition	inquire
inquisitiveness	inquire
insert	insert
insertion	insert
inset	inset
inshore	inshore
inside	inside
insider	inside
insight	insight
insightfulness	insight
insisting	insist
insistence	insist
insistency	insist
inspector	inspect
inspection	inspect
inspectorate	inspect
inspire	inspire
inspiration	inspire
install	install
installing	install
instalment	install
installment	install
installation	install
instance	instance
instancy	instance
instantiation	instance
instigant	instigate
instigator	instigate
instigation	instigate
instill	instil	instill
instilling	instil	instill
instilment	instil	instill
instillator	instil	instill
instillment	instil	instill
instillation	instil	instill
institute	institute
institution	institute
instructor	instruct
instruction	instruct
instructions	instruct
instrument	instrument
instrumental	instrument
instrumentality	instrument
instrumentation	instrument
insulant	insulate
insulator	insulate
insulation	insulate
insult	insult
insurer	insure
insurance	insure
intake	intake
integral	integrate
integrity	integrate
integrator	integrate
integration	integrate
integrating	integrate
intent	intend	intent
intention	intend	intent
intentness	intend	intent
intense	intense
intension	intense
intensity	intense
intensive	intense
intensiveness	intense
intensifier	intensify
intensification	intensify
intensificatiion	intensify
interment	inter
interaction	interact
intercept	intercept
interceptor	intercept
interception	intercept
interchange	interchange
interchangeability	interchange
interchangeableness	interchange
interconnection	interconnect
interest	interest
interference	interfere
interlude	interlude
intermediate	intermediate
intermediator	intermediate
intermediation	intermediate
intern	intern
interne	intern
internee	intern
internship	intern
internist	intern
internment	intern
international	international	internationalise
internationality	international	internationalise
internationalism	international	internationalise
internationalist	international	internationalise
internationalisation	international	internationalise
internationalization	international	internationalise
interpenetration	interpenetrate
interpreter	interpret
interpreting	interpret
interpretation	interpret
interrupter	interrupt
interruption	interrupt
intersect	intersect
intersection	intersect
intervention	intervene
interview	interview
interviewee	interview
interviewer	interview
intimacy	intimate
intimate	intimate
intimation	intimate
intimidation	intimidate
intrigue	intrigue
introduction	introduce
introject	introject
introjection	introject
intruder	intrude
intrusion	intrude
intrusiveness	intrude
inurement	inure
invader	invade
invasion	invade
invalid	invalid	invalidate
invalidism	invalid	invalidate
invalidity	invalid	invalidate
invalidness	invalid	invalidate
invalidation	invalid	invalidate
invent	invent
inventor	invent
invention	invent
inventiveness	invent
inventory	inventory
inventorying	inventory
inverse	invert	inverse
inverter	invert	inverse
inversion	invert	inverse
invest	invest
investor	invest
investing	invest
investment	invest
investigator	investigate
investigating	investigate
investigation	investigate
invite	invite
invitee	invite
invitation	invite
invoice	invoice
invocation	invoke
involvement	involve
inward	inward
inwardness	inward
iodin	iodinate
iodine	iodinate
iodination	iodinate
iron	iron
irons	iron
irony	iron
ironing	iron
ironist	iron
irrigation	irrigate
isolation	isolate
issue	issue
issus	issue
issuer	issue
issuant	issue
issuing	issue
issuance	issue
itch	itch
itching	itch
itchiness	itch
jab	jab
jabbing	jab
jack	jack
jacks	jack
jacket	jacket
jade	jade
jag	jag
jail	jail
jailer	jail
jailing	jail
jam	jam
jamming	jam
japan	japan
jar	jar
jarful	jar
jargon	jargon
jargonisation	jargon
jargonization	jargon
jaw	jaw
jaws	jaw
jawbone	jawbone
jazz	jazz
jeep	jeep
jelly	jelly
jellification	jelly
jeopardy	jeopardize
jerk	jerk
jerky	jerk
jerking	jerk
jerkiness	jerk
jest	jest
jester	jest
jet	jet
jets	jet
jewel	jewel
jeweler	jewel
jewelry	jewel
jeweller	jewel
jig	jig
jinx	jinx
jitterbug	jitterbug
job	job
jockey	jockey
join	join
joiner	join
joinder	join
joining	join
jointure	join
junction	join
joint	joint
jointer	joint
joke	joke
joker	joke
jolly	jolly
jollity	jolly
jolt	jolt
jostle	jostle
jostling	jostle
jostlement	jostle
justlement	jostle
jot	jot
jotting	jot
journey	journey
journeyer	journey
journeying	journey
journeyman	journey
joust	joust
joy	joy
joyride	joyride
judge	judge
judges	judge
judging	judge
judgment	judge
judgship	judge
judgement	judge
judgeship	judge
jug	jug
jugful	jug
juice	juice
juicer	juice
juiciness	juice
jumble	jumble
jump	jump
jumper	jump
jumpers	jump
jumping	jump
junk	junk
junker	junk
justifier	justify
justification	justify
kayo	kayo
keel	keel
keen	keen
keenness	keen
keep	keep
keeper	keep
keeping	keep
ken	ken
kenning	ken
key	key
keyboard	keyboard
keynote	keynote
kick	kick
kicker	kick
kicking	kick
kid	kid
kiddy	kid
kiddie	kid
kill	kill
killer	kill
killing	kill
kiss	kiss
kisser	kiss
kissing	kiss
kit	kit
kitten	kitten
knee	knee
kneecap	kneecap
kneel	kneel
kneeler	kneel
kneeling	kneel
knife	knife
knight	knight
knit	knit
knitting	knit
knock	knock
knocker	knock
knocking	knock
knot	knot
knowing	know
knowledge	know
knuckle	knuckle
knuckles	knuckle
label	label
labor	labor
laborer	labor
laboriousness	labor
labour	labour
labourer	labour
labourite	labour
lace	lace
lacing	lace
laceration	lacerate
lack	lack
lacquer	lacquer
lactation	lactate
ladder	ladder
lading	laden
ladle	ladle
ladleful	ladle
lag	lag
lager	lag
lagging	lag
lamb	lamb
lame	lame
lameness	lame
lament	lament
lamenter	lament
lamentation	lament
laminate	laminate
laminitis	laminate
lamination	laminate
lampoon	lampoon
lampooner	lampoon
lance	lance
lancer	lance
lancers	lance
land	land
landing	land
landman	land
landscape	landscape
landscaping	landscape
landscapist	landscape
lap	lap
lapful	lap
lapping	lap
lapse	lapse
lapsing	lapse
lard	lard
larder	lard
lark	lark
lash	lash
lasher	lash
lashing	lash
lashings	lash
lasso	lasso
last	last
latch	latch
lath	lathe
lathe	lathe
lathing	lathe
lather	lather
laugh	laugh
laugher	laugh
laughter	laugh
launch	launch
launcher	launch
launching	launch
laureate	laureate
laureation	laureate
lavishment	lavish
lavishness	lavish
lay	lay	layer
layer	lay	layer
laying	lay	layer
layman	lay	layer
laze	laze
leach	leach
leaching	leach
lead	lead
leader	lead
leaders	lead
leading	lead
leaf	leaf
leafing	leaf
league	league
leak	leak
leakage	leak
lean	lean
leaning	lean
leanness	lean
leap	leap
leaping	leap
leapfrog	leapfrog
learner	learn
learning	learn
lease	lease
lessee	lease
lessor	lease
leash	leash
leather	leather
leave	leave
leaver	leave
leaving	leave
lecture	lecture
lecturer	lecture
lecturing	lecture
lectureship	lecture
leg	leg
leger	leg
legacy	leg
legate	leg
legion	leg
legging	leg
legation	leg
legerity	leg
legislator	legislate
legislation	legislate
legislature	legislate
legislating	legislate
legitimacy	legitimate
legitimation	legitimate
legitimization	legitimate
lender	lend
lending	lend
lessening	lessen
let	let
letting	let
letter	letter
letters	letter
lettering	letter
letterman	letter
level	level
leveler	level
leveling	level
leveller	level
lever	lever	leverage
leverage	lever	leverage
leveraging	lever	leverage
levi	levy
levy	levy
levis	levy
li	lie
lie	lie
liar	lie
lied	lie
lying	lie
libel	libel
libeler	libel
liberal	liberate	liberalise	liberalize
liberator	liberate	liberalise	liberalize
liberality	liberate	liberalise	liberalize
liberalism	liberate	liberalise	liberalize
liberation	liberate	liberalise	liberalize
liberalness	liberate	liberalise	liberalize
liberalisation	liberate	liberalise	liberalize
liberalization	liberate	liberalise	liberalize
licence	licence
license	license
licensee	license
lick	lick
licking	lick
lift	lift
lifter	lift
liftman	lift
light	light	lighter	enlighten
lighter	light	lighter	enlighten
lighting	light	lighter	enlighten
lightness	light	lighter	enlighten
lightship	light	lighter	enlighten
enlightened	light	lighter	enlighten
enlightenment	light	lighter	enlighten
lightening	lighten
lightning	lightning
like	like
liking	like
likeness	like
likelihood	like
lilt	lilt
lime	lime
limit	limit
limiter	limit
limiting	limit
limitation	limit
limp	limp
limping	limp
limpness	limp
line	line
liner	line
lining	line
lineman	line
lineation	line
lingerer	linger
lingering	linger
link	link
links	link
linkage	link
linkman	link
lint	lint
lipstick	lipstick
liquid	liquidate
liquidity	liquidate
liquidator	liquidate
liquidizer	liquidate
liquidness	liquidate
liquidation	liquidate
liquefaction	liquidate
liquifaction	liquidate
liquidization	liquidate
list	list
lister	list
listing	list
listener	listen
listening	listen
lithograph	lithograph
lithography	lithograph
lithographer	lithograph
litter	litter
litterer	litter
life	live	enliven
liver	live	enliven
living	live	enliven
liveness	live	enliven
enlivenment	live	enliven
load	load
loads	load
loader	load
loading	load
loaf	loaf
loafer	loaf
loafing	loaf
loan	loan
loaner	loan
loathing	loath	loathe
loathsomeness	loath	loathe
lob	lob
lobby	lobby
lobbyist	lobby
locator	locate
locating	locate
location	locate
locative	locate
local	localize
locale	localize
localism	localize
locality	localize
localisation	localize
localization	localize
lock	lock
locke	lock
locker	lock
locking	lock
lockman	lock
lodge	lodge
lodger	lodge
lodging	lodge
lodgment	lodge
lodgings	lodge
lodgement	lodge
loft	loft
log	log
logging	log
long	long	lengthen
length	long	lengthen
longing	long	lengthen
longness	long	lengthen
lengthening	long	lengthen
look	look
looker	look
looking	look
loom	loom
loop	loop
looper	loop
looseness	loose
loosening	loosen
loot	loot
looter	loot
looting	loot
lope	lope
lord	lord
lordship	lord
loss	lose
loser	lose
losses	lose
losings	lose
lot	lot
lots	lot
lounge	lounge
lounger	lounge
louse	louse
lousiness	louse
love	love
lover	love
lovely	love
low	low
lowness	low
lower	lower
lowering	lower
lug	lug
luger	lug
luggage	lug
lull	lull
lumber	lumber
lumberman	lumber
lump	lump
lumper	lump
lunch	lunch
luncher	lunch
lunching	lunch
luncheon	luncheon
lung	lunge
lunge	lunge
lunger	lunge
lurch	lurch
lurcher	lurch
lure	lure
lurker	lurk
lust	lust
lustfulness	lust
luster	luster
lustre	lustre
lute	lute
luting	lute
lutist	lute
lutanist	lute
lyric	lyric
lyricism	lyric
lyricality	lyric
machine	machine
machinery	machine
machinist	machine
machinator	machine
machination	machine
madrigal	madrigal
mail	mail
mailer	mail
mailman	mail
mailing	mail
maintenance	maintain
major	major
majors	major
majority	major
make	make
maker	make
making	make
malice	malice
maliciousness	malice
maligner	malign
malignity	malign
malignancy	malign
malignance	malign
malignment	malign
malt	malt
malted	malt
maltman	malt
maltreatment	maltreat
man	man
manor	man
manfulness	man
manager	manage
managing	manage
management	manage
manageability	manage
manageableness	manage
mandate	mandate
maneuver	maneuver
maneuvering	maneuver
manifest	manifest
manifestation	manifest
manifold	manifold
manipulator	manipulate
manipulation	manipulate
manipulability	manipulate
manoeuvre	manoeuvre
mantle	mantle
manufacture	manufacture
manufacturer	manufacture
manufacturing	manufacture
manure	manure
map	map
mapping	map
mar	mar
mars	mar
marble	marble
marbles	marble
marbling	marble
march	march
marche	march
marcher	march
marches	march
marching	march
marine	marinade
mariner	marinade
marinade	marinade
marination	marinade
mark-up	mark-up
mark	mark
marker	mark
marking	mark
market	market
marketing	market
maroon	maroon
marri	marry
marriage	marry
marriageability	marry
marshal	marshal	marshaling
marshall	marshal	marshaling
marshaling	marshal	marshaling
marshalship	marshal	marshaling
martyr	martyr
martyrisation	martyr
martyrization	martyr
marvel	marvel
marvelment	marvel
mash	mash
masher	mash
mask	mask
masking	mask
masquerade	masquerade
mass	mass
masse	mass
masses	mass
massacre	massacre
massage	massage
massager	massage
master	master
mastery	master
mastering	master
mastership	master
mastermind	mastermind
mat	mat	matt
matt	mat	matt
matte	mat	matt
matman	mat	matt
matting	mat	matt
match	match
mate	mate
mater	mate
mates	mate
mating	mate
material	materialize
materialism	materialize
materialist	materialize
materiality	materialize
materialization	materialize
matriculate	matriculate
matriculation	matriculate
matter	matter
maturity	mature
maturing	mature
maturation	mature
maturement	mature
matureness	mature
maxim	maximise	maximize
maximation	maximise	maximize
maximisation	maximise	maximize
maximization	maximise	maximize
may	may
mayor	may
maze	maze
mazement	maze
mean	mean
means	mean
meaning	mean
meanness	mean
measure	measure
measuring	measure
measurement	measure
measurability	measure
meddler	meddle
meddling	meddle
meddlesomeness	meddle
medicine	medicine
meditation	meditate
meditativeness	meditate
meet	meet
meeting	meet
meld	meld
melt	melt
meltage	melt
melting	melt
memory	memorize
memorial	memorize
memorizer	memorize
memorisation	memorize
memorization	memorize
memorialisation	memorize
memorialization	memorize
menace	menace
mend	mend
mender	mend
mending	mend
mention	mention
merchandise	merchandise
merchandiser	merchandise
merchandising	merchandise
merchandisement	merchandise
merger	merge
merging	merge
mergence	merge
merit	merit
meritoriousness	merit
mesh	mesh
meshed	mesh
meshing	mesh
mess	mess
metal	metal
metalization	metal
metallisation	metal
metallization	metal
meter	meter
mew	mew
mews	mew
microfilm	microfilm
microwave	microwave
middle	middle
middling	middle
middleman	middle
might	might
migrant	migrate
migration	migrate
mildew	mildew
militant	militate
militance	militate
militancy	militate
militation	militate
milk	milk
milker	milk
milkman	milk
mill	mill
miller	mill
milling	mill
million	mill
millions	mill
mince	mince
mincer	mince
mind	mind
minder	mind
mindfulness	mind
mine	mine
miner	mine
mining	mine
minion	mine
minor	mine
mingling	mingle
minim	minimise	minimize
minimisation	minimise	minimize
minimization	minimise	minimize
minister	minister
ministry	minister
ministrant	minister
ministration	minister
minstrel	minstrel
mint	mint
mintage	mint
minute	minute
minutes	minute
minuteman	minute
minuteness	minute
mirror	mirror
misconduct	misconduct
misconduction	misconduct
miscount	miscount
misinterpretation	misinterpret
mismatch	mismatch
miss	miss
missal	miss
mission	miss
missioner	miss
missionary	miss
misstatement	misstate
mist	mist
mister	mist
mistake	mistake
mistaking	mistake
mistrust	mistrust
misunderstanding	misunderstand
misuse	misuse
miter	miter
mitigation	mitigate
mix	mix
mixer	mix
mixing	mix
mixture	mix
moan	moan
moaner	moan
mob	mob
mobile	mobilize
mobility	mobilize
mobilisation	mobilize
mobilization	mobilize
mock	mock
mocker	mock
mockery	mock
model	model
modeler	model
modeling	model
modeller	model
modelling	model
moderacy	moderate
moderate	moderate
moderator	moderate
moderation	moderate
moderatism	moderate
moderateness	moderate
modern	modernise	modernize
modernist	modernise	modernize
modernism	modernise	modernize
modernity	modernise	modernize
modernness	modernise	modernize
modernizing	modernise	modernize
modernisation	modernise	modernize
modernization	modernise	modernize
modifier	modify
modification	modify
moistening	moisten
mold	mold
molding	mold
molester	molest
molestation	molest
mollification	mollify
mollycoddle	mollycoddle
monitor	monitor
monitoring	monitor
monkey	monkey
monoply	monopolize
monopoly	monopolize
monopolist	monopolize
monopolizer	monopolize
monopolisation	monopolize
monopolization	monopolize
moon	moon
moonlight	moonlight
moonshine	moonshine
moonshiner	moonshine
mop	mop
mopping	mop
mortar	mortar
mortgage	mortgage
mortgagee	mortgage
mortgagor	mortgage
mothball	mothball
mother	mother
motion	motion
motive	motive	motivate
motivity	motive	motivate
motivation	motive	motivate
motley	motley
motor	motor
motorist	motor
motoring	motor
motorman	motor
motorisation	motor
motorization	motor
mould	mould
moult	mould
moulding	mould
moulting	mould
mound	mound
mount	mount
mounting	mount
mourner	mourn
mourning	mourn
mournfulness	mourn
mouse	mouse
mousing	mouse
mouth	mouth
mouthful	mouth
move	move
mover	move
moving	move
movement	move
muck	muck
mud	mud	muddy
muddiness	mud	muddy
muff	muff
mug	mug
mugful	mug
mugging	mug
mulch	mulch
multiple	multiply
multiplier	multiply
multiplicity	multiply
multiplication	multiply
mum	mum
mumbler	mumble
mumbling	mumble
munching	munch
murder	murder
murderer	murder
murderousness	murder
murmur	murmur
murmuring	murmur
murmuration	murmur
muscle	muscle
musculature	muscle
muse	muse
musing	muse
mushroom	mushroom
muster	muster
mute	mute
mutant	mute
mutation	mute
muteness	mute
mutiny	mutiny
mutineer	mutiny
mutter	mutter
mutterer	mutter
muttering	mutter
muzzle	muzzle
nail	nail
name	name
names	name
naming	name
nap	nap
narrow	narrow
narrowing	narrow
narrowness	narrow
nation	nationalize
national	nationalize
nationalist	nationalize
nationalism	nationalize
nationality	nationalize
nationalisation	nationalize
nationalization	nationalize
navigator	navigate
navigation	navigate
navigability	navigate
nearness	near
necessity	necessitate
necessitation	necessitate
neck	neck
necking	neck
necropsy	necropsy
need	need
needle	needle
negating	negate
negation	negate
negative	negative
negativism	negative
negativist	negative
negativity	negative
negativeness	negative
neglect	neglect
neglectfulness	neglect
negotiant	negotiate
negotiator	negotiate
negotiation	negotiate
negotiability	negotiate
neighbor	neighbor
neighbour	neighbour
nerve	nerve
nerves	nerve
nest	nest
nester	nest
nestor	nest
net	net
netting	net
network	network
neuter	neuter
neutering	neuter
neutral	neutralize
neutralist	neutralize
neutralism	neutralize
neutrality	neutralize
neutralisation	neutralize
neutralization	neutralize
nickel	nickel
nickname	nickname
nip	nip
nitrate	nitrate
nitration	nitrate
nod	nod
noise	noise
noisiness	noise
nominal	nominate
nomination	nominate
nominalism	nominate
nominating	nominate
nominative	nominate
noose	noose
normal	normalize
normality	normalize
normalisation	normalize
normalization	normalize
nose	nose
nosiness	nose
notch	notch
note	note
notion	note
notions	note
notation	note
notice	notice
noticeability	notice
noticeableness	notice
notifying	notify
notification	notify
nuance	nuance
nudge	nudge
nullification	nullify
numbness	numb
number	number
numbers	number
numbering	number
nurse	nurse
nursing	nurse
nurture	nurture
nurturing	nurture
nut	nut
nutation	nut
obedience	obey
object	object
objector	object
objection	object
objective	object
objectivity	object
objectiveness	object
objectionability	object
objectionableness	object
obligation	oblige	obligate
obliteration	obliterate
obscurity	obscure
obscuration	obscure
obscureness	obscure
observer	observe
observant	observe
observance	observe
observation	observe
observatory	observe
obstruction	obstruct
obtainment	obtain
occasion	occasion
occasions	occasion
occasionment	occasion
occupant	occupy
occupier	occupy
occupancy	occupy
occupying	occupy
occupation	occupy
occurence	occur
offing	of
offense	offend
offender	offend
offensive	offend
offensiveness	offend
offer	offer
offering	offer
office	officer	officiate
officer	officer	officiate
official	officer	officiate
officiating	officer	officiate
officiation	officer	officiate
officiousness	officer	officiate
offset	offset
oil	oil
oiler	oil
oilman	oil
okay	okay
omen	omen
omission	omit
omnibus	omnibus
ooze	ooze
oozing	ooze
opal	opt
option	opt
optative	opt
open	open
opener	open
opening	open
openness	open
operator	operate
operation	operate
operative	operate
operations	operate
operability	operate
opposite	oppose
opposition	oppose
oppositeness	oppose
optimum	optimize
optimism	optimize
optimisation	optimize
optimization	optimize
orator	orate
oration	orate
orb	orb
orbit	orbit
ordinal	ordain
ordinate	ordain
ordaining	ordain
ordinance	ordain
ordainment	ordain
ordination	ordain
order	order
ordering	order
organ	organize
organs	organize
organic	organize
organist	organize
organism	organize
organizer	organize
organization	organize
organisation	organise
orient	orient
oriental	orient
orientation	orient
orientalisation	orient
orientalization	orient
origin	originate
original	originate
originator	originate
originalism	originate
originality	originate
origination	originate
ornament	ornament
ornamental	ornament
ornamentation	ornament
orphan	orphan
orphanage	orphan
ossification	ossify
ouster	oust
ousting	oust
out	out
outing	out
outcry	outcry
outfit	outfit
outfitting	outfit
outgrowth	outgrow
outlaw	outlaw
outlay	outlay
outline	outline
output	output
outrage	outrage
outrageousness	outrage
outreach	outreach
outspread	outspread
outwardness	outward
overburden	overburden
overcast	overcast
overcasting	overcast
overexposure	overexpose
overflow	overflow
overflowing	overflow
overhang	overhang
overhaul	overhaul
overhauling	overhaul
overhead	overhead
overlap	overlap
overlapping	overlap
overlay	overlay
overlayer	overlay
overload	overload
overlook	overlook
overnighter	overnight
override	override
overrun	overrun
overseer	oversee
overshoot	overshoot
oversupply	oversupply
overtaking	overtake
overthrow	overthrow
overturn	overturn
overturning	overturn
overweight	overweight
owner	own
oyster	oyster
pace	pace
pacer	pace
pacing	pace
pacific	pacify
pacifier	pacify
pacifist	pacify
pacifism	pacify
pacification	pacify
pack	pack	package
packer	pack	package
package	pack	package
packing	pack	package
packaging	pack	package
pad	pad
padding	pad
padlock	padlock
page	page
paging	page
pageant	page
pageantry	page
pagination	page
pain	pain
pains	pain
painfulness	pain
paint	paint
painter	paint
painting	paint
pair	pair
pairing	pair
pal	pal
pale	pale
paling	pale
paleness	pale
pall	pall
pallor	pall
palm	palm
palmer	palm
palmist	palm
palsy	palsy
pampering	pamper
pan	pan
panful	pan
panel	panel
paneling	panel
panelist	panel
panelling	panel
panhandle	panhandle
panhandler	panhandle
panic	panic
pantomime	pantomime
pantomimer	pantomime
pantry	pantry
paper	paper
papers	paper
paperer	paper
papering	paper
par	par
parachute	parachute
parachuter	parachute
parachuting	parachute
parachutist	parachute
parade	parade
parader	parade
paragraph	paragraph
paragrapher	paragraph
parallel	parallel
parallelism	parallel
paralysis	paralyse	paralyze
paralysation	paralyse	paralyze
paralyzation	paralyse	paralyze
parapet	parapet
paraphrase	paraphrase
parcel	parcel
parceling	parcel
parcelling	parcel
pardon	pardon
pardoner	pardon
parer	pare	parent
parent	pare	parent
paring	pare	parent
parings	pare	parent
parentage	pare	parent
park	park
parking	park
parley	parley
parody	parody
parodist	parody
parole	parole
parolee	parole
parquet	parquet
part	part	partition
parts	part	partition
parting	part	partition
partition	part	partition
partitive	part	partition
partitionist	part	partition
partitioning	part	partition
partaker	partake
party	party
participant	participate
participance	participate
participation	participate
partner	partner
partnership	partner
pass	pass
passer	pass
passion	pass
passing	pass
passeres	pass
passionateness	pass
passage	passages
past	paste
paste	paste
pasty	paste
pastis	paste
pastor	paste
pasties	paste
pastness	paste
pastoral	paste
pastorate	paste
pasture	pasture
pat	pat
pater	pat
patness	pat
patch	patch
patching	patch
patent	patent
patentee	patent
patrol	patrol
patroller	patrol
patrolman	patrol
patrolling	patrol
patron	patronage	patronize
patronage	patronage	patronize
patronization	patronage	patronize
patter	patter
pattern	pattern
pause	pause
paving	pave
pavement	pave
pavilion	pavilion
paw	paw
pawn	pawn
pawnee	pawn
pawnage	pawn
pawning	pawn
pay	pay
payee	pay
payer	pay
paying	pay
payment	pay
peach	peach
peak	peak
pearl	pearl
pearler	pearl
pearlite	pearl
peck	peck
pecker	peck
pedal	pedal
pedaler	pedal
pedaller	pedal
peddler	peddle
peddling	peddle
peel	peel
peeler	peel
peer	peer
peg	peg
pen	pen	penance
penman	pen	penance
penance	pen	penance
penning	pen	penance
penalisation	penalise	penalize
penalization	penalise	penalize
pencil	pencil
penetration	penetrate
penetrability	penetrate
pension	pension
pensioner	pension
people	people
pep	pep
pepper	pepper
percept	perceive
perceiver	perceive
perception	perceive
perceiving	perceive
perceptivity	perceive
perceptibility	perceive
perceptiveness	perceive
perch	perch
perfect	perfect
perfection	perfect
perfective	perfect
perfectability	perfect
perfectibility	perfect
performer	perform
performing	perform
performance	perform
perfume	perfume
perfumer	perfume
perfumery	perfume
peril	peril
perilousness	peril
perisher	perish
perishables	perish
perk	perk
permeation	permeate
permeability	permeate
permeableness	permeate
permit	permit
permission	permit
permissibility	permit
permissiveness	permit
peroxide	peroxide
perpetuity	perpetuate
perpetuation	perpetuate
perplexity	perplex
perseverance	persevere
perseverence	persevere
perseveration	persevere
persistence	persist
persistency	persist
person	personalize
personal	personalize
personage	personalize
personation	personalize
personality	personalize
personableness	personalize
personalisation	personalize
personalization	personalize
persuader	persuade
persuasion	persuade
persuasiveness	persuade
pertinence	pertain
pertinency	pertain
pertinacity	pertain
pesterer	pester
pet	pet
petting	pet
petition	petition
petitioner	petition
phase	phase
phone	phone
phoner	phone
photo	photo
photograph	photograph
photographer	photograph
phrase	phrase
phrasing	phrase
pick	pick
picker	pick
picking	pick
picket	picket
pickle	pickle
picnic	picnic
picnicker	picnic
picture	picture
picturing	picture
piece	piece
pig	pig	pigment
pigman	pig	pigment
piggery	pig	pigment
pigment	pig	pigment
pigmentation	pig	pigment
pigeonhole	pigeonhole
pigeonholing	pigeonhole
pike	pike
pile	pile
piles	pile
piling	pile
pilgrim	pilgrimage
pilgrimage	pilgrimage
pillage	pillage
pillager	pillage
pillaging	pillage
pillow	pillow
pilot	pilot
pilotage	pilot
piloting	pilot
pimp	pimp
pin	pin
pinning	pin
pinch	pinch
pinche	pinch
pine	pine
pining	pine
pink	pink
pinnacle	pinnacle
pinpoint	pinpoint
pioneer	pioneer
pip	pip
pipe	pipe
piper	pipe
pipes	pipe
piping	pipe
pipeful	pipe
pique	pique
piquance	pique
piquancy	pique
piracy	pirate
pirate	pirate
pirouette	pirouette
piss	piss
pissing	piss
pit	pit
pitman	pit
pitting	pit
pitch	pitch
pitcher	pitch
pitching	pitch
pitcherful	pitch
pitchfork	pitchfork
pith	pith
pity	pity
pivot	pivot
place	place
placer	place
placeman	place
placement	place
plague	plague
plain	plain
plainness	plain
plan	plan
planning	plan
plane	plane
planer	plane
planation	plane
planeness	plane
plank	plank
planking	plank
plant	plant
planter	plant
planting	plant
plantation	plant
plaster	plaster
plasterer	plaster
plastering	plaster
plate	plate
plating	plate
plateful	plate
play	play
player	play
playing	play
playback	playback
plea	plead
pleading	plead
pleasant	please	pleasure
pleasure	please	pleasure
pleasing	please	pleasure
pleasance	please	pleasure
pleasantry	please	pleasure
pleasantness	please	pleasure
pledge	pledge
plight	plight
plod	plod
plodding	plod
plot	plot
plough	plough
ploughing	plough
ploughman	plough
plow	plow
plowing	plow
pluck	pluck
plug	plug
plumb	plumb
plumber	plumb
plumbing	plumb
plumbism	plumb
plume	plume
plumage	plume
plummet	plummet
plump	plump
plumpness	plump
plunder	plunder
plunderer	plunder
plunderage	plunder
plundering	plunder
plunge	plunge
plunger	plunge
pocket	pocket
pocketful	pocket
pod	pod
point	point
pointer	point
pointing	point
poise	poise
poison	poison
poisoner	poison
poisoning	poison
poke	poke
poker	poke
poking	poke
pole	pole	polarize
poler	pole	polarize
polarity	pole	polarize
polarisation	pole	polarize
polarization	pole	polarize
police	police
policeman	police
polish	polish
polisher	polish
polishing	polish
polka	polka
poll	poll
polls	poll
pollard	pollard
ponderousness	ponder
pool	pool
pop	pop
popping	pop
populism	populate
populating	populate
population	populate
pore	pore
porosity	pore
port	port	portion	portend
portal	port	portion	portend
porter	port	portion	portend
portent	port	portion	portend
portion	port	portion	portend
portrayal	portray
portraying	portray
pose	pose	position
poser	pose	position
posing	pose	position
position	pose	position
positive	pose	position
positioner	pose	position
positivity	pose	position
positioning	pose	position
positiveness	pose	position
possess	possess
possessor	possess
possession	possess
possessive	possess
possessiveness	possess
post	post	poster
poster	post	poster
posting	post	poster
postman	post	poster
posterity	post	poster
postmark	postmark
postponer	postpone
postponement	postpone
postscript	postscript
postulant	postulate
postulate	postulate
postulation	postulate
posture	posture
posturing	posture
pot	pot
potful	pot
potion	pot
potman	pot
pottery	pot
potation	pot
pouch	pouch
poultice	poultice
pound	pound
poundal	pound
pounder	pound
pounding	pound
pouring	pour
pout	pout
powder	powder
power	power
powerfulness	power
practice	practice	practise
practise	practice	practise
practicality	practice	practise
practicability	practice	practise
practicableness	practice	practise
prayer	pray
praise	praise
prank	prank
prawn	prawn
preacher	preach
preaching	preach
preachment	preach
preamble	preamble
precaution	precaution
precedent	precede
precedence	precede
precedency	precede
precipitant	precipitate
precipitate	precipitate
precipitance	precipitate
precipitancy	precipitate
precipitator	precipitate
precipitation	precipitate
precipitateness	precipitate
precipitousness	precipitate
preclusion	preclude
precondition	precondition
predictor	predict
prediction	predict
predictability	predict
predominance	predominate
predomination	predominate
preemption	preempt
preface	preface
preference	prefer
preferment	prefer
preferability	prefer
prejudice	prejudice
prelude	prelude
prelusion	prelude
premier	premier	premiere
premiere	premier	premiere
premiership	premier	premiere
premise	premise
premises	premise
preparation	prepare
preparative	prepare
prepayment	prepay
preposition	preposition
presage	presage
prescribe	prescribe
prescript	prescribe
prescription	prescribe
present	present
presence	present
presenter	present
presentment	present
presentness	present
presentation	present
preserve	preserve
preserver	preserve
preserves	preserve
preserving	preserve
preservation	preserve
preservative	preserve
preside	preside
president	preside
presidency	preside
press	press	pressure	pressurise
pressure	press	pressure	pressurise
pressman	press	pressure	pressurise
pressing	press	pressure	pressurise
pressurisation	press	pressure	pressurise
pressurization	press	pressure	pressurise
presumption	presume
presumptuousness	presume
presupposition	presuppose
pretence	pretend	pretense
pretense	pretend	pretense
pretender	pretend	pretense
pretending	pretend	pretense
pretension	pretend	pretense
prevalence	prevail
prevent	prevent
prevention	prevent
preventive	prevent
preventative	prevent
preview	preview
prey	prey
preying	prey
predator	prey
predation	prey
price	price
pricing	price
prick	prick
pricker	prick
pricking	prick
pride	pride
pridefulness	pride
prime	prim	prime
primer	prim	prime
primacy	prim	prime
priming	prim	prime
primness	prim	prime
print	print
printer	print
printing	print
privacy	privatize
private	privatize
privates	privatize
privateer	privatize
privation	privatize
privateness	privatize
privilege	privilege
prize	prize
probate	probate
probation	probate
probe	probe
probing	probe
process	proceed	process
proceeds	proceed	process
procedure	proceed	process
processor	proceed	process
proceeding	proceed	process
processing	proceed	process
procession	proceed	process
proceedings	proceed	process
processional	proceed	process
proclaim	proclaim
proclamation	proclaim
procrastinator	procrastinate
procrastination	procrastinate
proctor	proctor
procure	procure
procural	procure
procurer	procure
procurance	procure
procurator	procure
procurement	procure
prod	prod
prodding	prod
produce	produce
product	produce
producer	produce
production	produce
productivity	produce
productiveness	produce
profanity	profane
profanation	profane
profaneness	profane
professor	profess
profession	profess
professing	profess
professional	profess
professionalism	profess
profile	profile
profit	profit
profits	profit
profiteer	profit
profiteering	profit
profitability	profit
profitableness	profit
profundity	profound
profoundness	profound
profuse	profuse
profusion	profuse
profuseness	profuse
program	program
programming	program
programme	programme
programmer	programme
progress	progress
progression	progress
progressive	progress
progressivity	progress
progressiveness	progress
prohibition	prohibit
project	project
projector	project
projection	project
prolongment	prolong
prolongation	prolong
promenade	promenade
promise	promise
promisee	promise
promiser	promise
promisor	promise
promote	promote
promoter	promote
promotion	promote
prompt	prompt
prompter	prompt
prompting	prompt
promptness	prompt
pronouncement	pronounce
pronunciation	pronounce
proof	proof	prove
proving	proof	prove
provence	proof	prove
provencal	proof	prove
provenance	proof	prove
prop	prop
propman	prop
propagator	propagate
propagation	propagate
propeller	propel
propellant	propel
propellent	propel
propulsion	propel
propitiation	propitiate
propitiousness	propitiate
proportion	proportion	proportionate
proportional	proportion	proportionate
proportionment	proportion	proportionate
proportionality	proportion	proportionate
proportionation	proportion	proportionate
proportionateness	proportion	proportionate
propose	propose
proposal	propose
proposer	propose
proposition	proposition
prorate	prorate
proration	prorate
proscribe	proscribe
proscription	proscribe
prosecutor	prosecute
prosecution	prosecute
prospect	prospect
prospector	prospect
prosperity	prosper
prostate	prostate
prostatitis	prostate
prostitute	prostitute
prostitution	prostitute
prostration	prostrate
protector	protect
protecting	protect
protection	protect
protectorate	protect
protectiveness	protect
prototype	prototype
protrusion	protrude
provider	provide	provision
provision	provide	provision
providing	provide	provision
providence	provide	provision
provisions	provide	provision
provisioner	provide	provision
provoker	provoke
provocation	provoke
provocative	provoke
prowl	prowl
prowler	prowl
prune	prune
pruner	prune
pruning	prune
pry	pry
prior	pry
prying	pry
public	publish	publicise	publicize
publicist	publish	publicise	publicize
publicity	publish	publicise	publicize
publisher	publish	publicise	publicize
publicizer	publish	publicise	publicize
publishing	publish	publicise	publicize
publication	publish	publicise	publicize
publicizing	publish	publicise	publicize
publicization	publish	publicise	publicize
puddle	puddle
puddler	puddle
puff	puff
puffer	puff
puke	puke
puking	puke
pull	pull
pullman	pull
pulling	pull
pulp	pulp
pulse	pulse
pulsing	pulse
pulsation	pulse
pump	pump
pumps	pump
pun	pun
punning	pun
punch	punch
puncher	punch
punishment	punish
punt	punt
punter	punt
punting	punt
pup	pup
purchase	purchase
purchaser	purchase
purchasing	purchase
puree	puree
pureness	puree
purge	purge
purging	purge
purgation	purge
purgative	purge
purgatory	purge
purifier	purify
purification	purify
purple	purple
purpleness	purple
purport	purport
purpose	purpose
purposefulness	purpose
purse	purse
purser	purse
pursued	pursue
pursuer	pursue
pursuit	pursue
pursuant	pursue
pursuance	pursue
push	push
pusher	push
pushing	push
put	put
putting	put
putt	putt	putter
puttee	putt	putter
putter	putt	putter
puttees	putt	putter
putterer	putt	putter
putty	putty
puzzle	puzzle
puzzler	puzzle
puzzlement	puzzle
pyramid	pyramid
quack	quack
quackery	quack
quadruple	quadruple
quadrupling	quadruple
quadruplicate	quadruple
quadruplication	quadruple
quake	quake
quaker	quake
quakers	quake
quakerism	quake
qualifier	qualify
qualifying	qualify
qualification	qualify
quantifier	quantify
quantification	quantify
quantifiability	quantify
quarantine	quarantine
quarrel	quarrel
quarrelsomeness	quarrel
quarry	quarry
quarrier	quarry
quarrying	quarry
quarryman	quarry
quarter	quarter
quarters	quarter
quartering	quarter
quarterback	quarterback
quaver	quaver
queen	queen
queens	queen
queer	queer
queerness	queer
quelling	quell
quenching	quench
query	query
quest	quest
question	question
questioner	question
questioning	question
quibble	quibble
quibbler	quibble
quickening	quicken
quickstep	quickstep
quiet	quiet
quietism	quiet
quietist	quiet
quietness	quiet
quirk	quirk
quiz	quiz
quizzer	quiz
quote	quote
quotation	quote
rabbit	rabbit
race	race
racer	race
racism	race
racing	race
racist	race
rack	rack
racket	racket	racketeer
racketeer	racket	racketeer
racketeering	racket	racketeer
radiator	radiate
radiation	radiate
radio	radio
raft	raft
rafts	raft
rafter	raft
raftman	raft
rag	rag
rage	rage
ragee	rage
raid	raid
raider	raid
rail	rail
rails	rail
railing	rail
railroad	railroad
railroader	railroad
rain	rain
raise	raise
raiser	raise
raising	raise
rake	rake
rally	rally
rallying	rally
ram	ram
ramee	ram
ramman	ram
ramble	ramble
rambler	ramble
ramp	ramp
rampage	rampage
ranch	ranch
ranching	ranch
range	range
ranger	range
rank	rank
ranker	rank
ranking	rank
rankness	rank
ransacking	ransack
ransom	ransom
rap	rap
rape	rape
raper	rape
rapist	rape
rapture	rapture
rasp	rasp
rasping	rasp
rat	rat
ratting	rat
rate	rate
rating	rate
ratifier	ratify
ratification	ratify
ration	ration	rationalise	rationalize
rationing	ration	rationalise	rationalize
rationality	ration	rationalise	rationalize
rationalist	ration	rationalise	rationalize
rationalism	ration	rationalise	rationalize
rationalness	ration	rationalise	rationalize
rationalisation	ration	rationalise	rationalize
rationalization	ration	rationalise	rationalize
rattle	rattle
rattler	rattle
rattling	rattle
ray	ray
razor	razor
razing	razor
re-exportation	re-export
reach	reach
reaching	reach
react	react
reactor	react
reactant	react
reaction	react
reactance	react
reactionism	react
reactivity	reactivate
reactivation	reactivate
read	read
reader	read
reading	read
readjustment	readjust
ready	ready
readying	ready
readiness	ready
realist	realise	realize
realisation	realise	realize
realization	realise	realize
reaper	reap
reappearance	reappear
rear	rear
rearing	rear
rearrangement	rearrange
reason	reason
reasoner	reason
reasoning	reason
reasonableness	reason
reassembly	reassemble
reassessment	reassess
reassignment	reassign
reassurance	reassure
rebate	rebate
rebel	rebel
rebellion	rebel
rebound	rebound
rebuff	rebuff
rebuilding	rebuild
rebuke	rebuke
rebuttal	rebut
rebutter	rebut
recall	recall
recap	recapitulate
recapitulation	recapitulate
recapitalization	recapitalize
recapture	recapture
recess	recede	recess
receding	recede	recess
recession	recede	recess
recessional	recede	recess
receipt	receipt	receive
receipts	receipt	receive
receiver	receipt	receive
receptor	receipt	receive
reception	receipt	receive
recipient	receipt	receive
receiving	receipt	receive
receivables	receipt	receive
receptivity	receipt	receive
receptiveness	receipt	receive
reciprocal	reciprocate
reciprocity	reciprocate
reciprocality	reciprocate
reciprocation	reciprocate
recital	recite
recitation	recite
recitative	recite
reckoner	reckon
reckoning	reckon
reclamation	reclaim
recognition	recognise	recognize
recognisance	recognise	recognize
recognizance	recognise	recognize
recoil	recoil
recollection	recollect
recommendation	recommend
recompence	recompence
recompense	recompense
recompensation	recompense
reconciler	reconcile
reconcilement	reconcile
reconciliation	reconcile
reconsideration	reconsider
reconstruction	reconstruct
record	record
recorder	record
recording	record
recordation	record
recount	recount
recountal	recount
recounting	recount
recoupment	recoup
recover	recover
recovery	recover
recoverer	recover
recreation	recreate
recruit	recruit
recruiter	recruit
recruitment	recruit
rectifier	rectify
rectification	rectify
recur	recur
recurse	recur
recursion	recur
recurrence	recur
recycling	recycle
rededication	rededicate
redeemer	redeem
redemption	redeem
redeployment	redeploy
redirection	redirect
redouble	redouble
redress	redress
reducer	reduce
reducing	reduce
reduction	reduce
reek	reek
reel	reel
reevaluation	reevaluate
reexamination	reexamine
referent	refer	reference
referral	refer	reference
reference	refer	reference
referee	referee
refereeing	referee
refill	refill
refilling	refill
refine	refine	refinance
refiner	refine	refinance
refinery	refine	refinance
refining	refine	refinance
refinement	refine	refinance
reflation	reflate
reflector	reflect
reflection	reflect
reflectance	reflect
reflectivity	reflect
reflex	reflex
reflexive	reflex
reflexivity	reflex
reflexiveness	reflex
reform	reform
reformer	reform
reformist	reform
reformation	reform
reformatory	reform
refrain	refrain
refrainment	refrain
refresher	refresh
refreshment	refresh
refueling	refuel
refuge	refuge
refund	refund
refuse	refuse
refusal	refuse
refuting	refute
refutation	refute
regaining	regain
regard	regard
regards	regard
regeneration	regenerate
regiment	regiment
regimentals	regiment
regimentation	regiment
register	register
registry	register
registrar	register
registrant	register
registration	register
regret	regret
regrets	regret
regular	regularize
regularity	regularize
regularisation	regularize
regularization	regularize
regulator	regulate
regulation	regulate
regulating	regulate
rehabilitation	rehabilitate
rehash	rehash
rehearse	rehearse
rehearsal	rehearse
reign	reign
reimbursement	reimburse
rein	rein
reins	rein
reinforcer	reinforce
reinforcement	reinforce
reinstatement	reinstate
reinterpretation	reinterpret
reinvestment	reinvest
reissue	reissue
reiteration	reiterate
reject	reject
rejection	reject
rejoicing	rejoice
relation	relate
relative	relate
relations	relate
relativity	relate
relaxant	relax
relaxation	relax
relay	relay
relays	relay
release	release
relief	relieve
reliever	relieve
relinquishing	relinquish
relinquishment	relinquish
relish	relish
relishing	relish
reliving	relive
relocation	relocate
reliant	rely
reliance	rely
remains	remain	remainder
remainder	remain	remainder
remanence	remain	remainder
remake	remake
remaking	remake
remark	remark
remedy	remedy
remediation	remedy
remember	remember
remembering	remember
remembrance	remember
remind	remind
reminder	remind
remittal	remit
remission	remit
remittance	remit
remissness	remit
remittence	remit
remonstrant	remonstrate
remonstrance	remonstrate
remonstration	remonstrate
remove	remove
removal	remove
remover	remove
rent	rend	rent
rente	rend	rent
rental	rend	rent
renter	rend	rent
renting	rend	rent
render	render
rendering	render
rendition	render
rendezvous	rendezvous
renege	renege
renegotiation	renegotiate
renew	renew	renewal
renewal	renew	renewal
renouncement	renounce
renunciation	renounce
renovator	renovate
renovation	renovate
renown	renown
reordering	reorder
reorganization	reorganize
repair	repair
repairer	repair
repairman	repair
reparable	repair
reparation	repair
repatriate	repatriate
repatriation	repatriate
repayment	repay
repeal	repeal
repeat	repeat	repetition
repeater	repeat	repetition
repeating	repeat	repetition
repetition	repeat	repetition
repetitiveness	repeat	repetition
repetitiousness	repeat	repetition
repulse	repel
repellant	repel
repellent	repel
repelling	repel
repulsion	repel
repulsiveness	repel
repentant	repent
repentance	repent
replacing	replace
eplacement	replace
replacement	replace
replaceability	replace
replenishment	replenish
repletion	replete
reply	reply
report	report
reporter	report
reportage	report
reporting	report
repose	repose
reposal	repose
repositing	reposition
reposition	reposition
repositioning	reposition
represent	represent
representation	represent
representative	represent
repress	repress
repression	repress
reprieve	reprieve
reprievement	reprieve
reproach	reproach
reproachment	reproach
reprobate	reprobate
reprobation	reprobate
reproducer	reproduce
reproduction	reproduce
reproducibility	reproduce
reproof	reproof
repudiation	repudiate
repute	repute
reputation	repute
reputability	repute
request	request
requisite	require	requisition
requirement	require	requisition
requisition	require	requisition
requisiteness	require	requisition
rescinding	rescind
rescission	rescind
rescindment	rescind
rescue	rescue
rescuer	rescue
research	research
researcher	research
resemblant	resemble
resemblance	resemble
resentment	resent
reserve	reserve
reserves	reserve
reservist	reserve
reservation	reserve
reset	reset
resettlement	resettle
reshuffle	reshuffle
reshuffling	reshuffle
resident	reside
residence	reside
residency	reside
resign	resign
resignation	resign
resin	resin
resination	resin
resister	resist
resistor	resist
resistant	resist
resistance	resist
resistivity	resist
resolve	resolve
resolute	resolve
resolvent	resolve
resolving	resolve
resolution	resolve
resoluteness	resolve
resort	resort
respect	respect
respects	respect
respecter	respect
respectability	respect
respectfulness	respect
respite	respite
response	respond
responder	respond
respondent	respond
responsibility	respond
responsiveness	respond
responsibleness	respond
rest	rest
restfulness	rest
restatement	restate
restore	restore
restorer	restore
restoration	restore
restorative	restore
restrain	restrain
restraint	restrain
restriction	restrict
restrictiveness	restrict
result	result
resultant	result
resume	resume
resumption	resume
resurge	resurge
resurgence	resurge
resurrection	resurrect
retail	retail
retailer	retail
retailing	retail
retainer	retain
retention	retain
retentivity	retain
retentiveness	retain
retaliator	retaliate
retaliation	retaliate
retard	retard
retardment	retard
retardation	retard
rethink	rethink
reticule	reticulate
reticulation	reticulate
retire	retire
retiree	retire
retirement	retire
retort	retort
retorsion	retort
retortion	retort
retract	retract
retractor	retract
retraction	retract
retreat	retreat
retreated	retreat
retreatant	retreat
retrieve	retrieve
retrieval	retrieve
retriever	retrieve
retrograde	retrograde
retrogradation	retrograde
retrospect	retrospect
retrospection	retrospect
retrospective	retrospect
return	return
reunion	reunite
revaluation	revalue
revamping	revamp
revel	revel	reveal
reveal	revel	reveal
reveler	revel	reveal
revelry	revel	reveal
reveller	revel	reveal
revelment	revel	reveal
revealing	revel	reveal
revelation	revel	reveal
revenge	revenge
revere	reverence
revers	reverence
reverence	reverence
reverse	revert	reverse
reversal	revert	reverse
reversion	revert	reverse
reverting	revert	reverse
reversible	revert	reverse
reversibility	revert	reverse
review	review
reviewer	review
revise	revise
revisal	revise
reviser	revise
revising	revise
revision	revise
revitalisation	revitalise	revitalize
revitalization	revitalise	revitalize
revival	revive
revivalism	revive
revoke	revoke
revocable	revoke
revocation	revoke
revocability	revoke
revolt	revolt	revolve
revolver	revolt	revolve
revolution	revolt	revolve
revolutionary	revolt	revolve
reward	reward
rewrite	rewrite
rewriter	rewrite
rewriting	rewrite
rhyme	rhyme
rib	rib
ribbing	rib
riddance	rid
riddle	riddle
ride	ride
rider	ride
riding	ride
ridge	ridge
ridicule	ridicule
ridiculousness	ridicule
riffle	riffle
rifle	rifle
rifling	rifle
rifleman	rifle
rig	rig
rigor	rig
rigging	rig
rigorousness	rig
right	right
rightist	right
rightness	right
rightfulness	right
rim	rim
rime	rime
ring	ring
rung	ring
ringer	ring
ringing	ring
rinse	rinse
rinsing	rinse
riot	riot
rioter	riot
rioting	riot
rip	rip
ripple	ripple
rippling	ripple
rise	rise
riser	rise
rising	rise
risk	risk
risking	risk
rival	rival
rivalry	rival
roam	roam
roamer	roam
roar	roar
roarer	roar
roaring	roar
roast	roast
roaster	roast
roasting	roast
robbery	rob
robe	robe
rock	rock
rocker	rock
rocket	rocket
rocketry	rocket
roll	roll
roller	roll
rolling	roll
romance	romance
romantic	romance
romanticist	romanticize
romanticism	romanticize
romanticisation	romanticize
romanticization	romanticize
romp	romp
romper	romp
roof	roof
roofer	roof
roofing	roof
room	room
rooms	room
roomer	room
roomful	room
roost	roost
rooster	roost
root	root
rooting	root
rope	rope
roping	rope
rot	rot
rotor	rot
rotting	rot
rottenness	rot
rotation	rotate
rouge	rouge
rough	rough
roughage	rough
roughness	rough
roughcast	roughcast
round	round
roundness	round
rouse	rouse
rousing	rouse
rout	rout	route
route	rout	route
rove	rove
rover	rove
roving	rove
row	row
rower	row
rowing	row
rub	rub
rubbing	rub
rubber	rubber
rubberization	rubber
rubbish	rubbish
rubric	rubric
rubrication	rubric
rue	rue
ruin	ruin
ruiner	ruin
ruining	ruin
ruination	ruin
rule	rule
ruler	rule
ruling	rule
rumble	rumble
rumbling	rumble
rumor	rumor
rumour	rumour
rumpus	rumpus
run	run
running	run
runniness	run
rupture	rupture
rush	rush
rushing	rush
rust	rust
rusting	rust
rustle	rustle
rustler	rustle
rustling	rustle
rut	rut
saber	saber
sabotage	sabotage
sabre	sabre
sack	sack
sackful	sack
sacking	sack
sacrifice	sacrifice
sadness	sad
saddle	saddle
saddler	saddle
safari	safari
safeguard	safeguard
sag	sag
sail	sail
sailor	sail
sailing	sail
saint	saint
sale	sell
sell	sell
sales	sell
seller	sell
selling	sell
salability	sell
saliva	salivate
salivation	salivate
sallow	sallow
sallowness	sallow
salt	salt
salting	salt
salute	salute
salutation	salute
salvage	salvage
salvager	salvage
salve	salve
salver	salve
salvor	salve
salvation	salve
sample	sample
sampler	sample
sampling	sample
sanction	sanction
sand	sand
sands	sand
sandal	sand
sander	sand
sandpaper	sandpaper
sandwich	sandwich
sandwichman	sandwich
sap	sap
satellite	satellite
satiation	satiate
satisfying	satisfy
satisfaction	satisfy
sauce	sauce
saucer	sauce
sauteing	saute
savage	savage
savagery	savage
savageness	savage
save	save	savor
savor	save	savor
saver	save	savor
savant	save	savor
saving	save	savor
savings	save	savor
savoring	save	savor
savvy	savvy
saw	saw
sawyer	saw
say	say
saying	say
scald	scald
scale	scale
scalar	scale
scales	scale
scaling	scale
scalp	scalp
scan	scan
scanning	scan
scantness	scant
scar	scar
scare	scare
scarf	scarf
scarification	scarify
scatter	scatter
scattering	scatter
scent	scent
schedule	schedule
scheduling	schedule
scheme	scheme
schemer	scheme
school	school
schooling	school
schoolman	school
scoop	scoop
scoopful	scoop
scooping	scoop
score	score
scorer	score
scores	score
scorn	scorn
scour	scour
scours	scour
scourer	scour
scouring	scour
scourge	scourge
scout	scout
scouting	scout
scramble	scramble
scrambler	scramble
scrap	scrap	scrape
scrape	scrap	scrape
scraps	scrap	scrape
scraper	scrap	scrape
scraping	scrap	scrape
scratch	scratch
scratching	scratch
scream	scream
screamer	scream
screaming	scream
screech	screech
screeching	screech
screen	screen
screening	screen
screw	screw
screwing	screw
scribe	scribe
scriber	scribe
scrimmage	scrimmage
script	script
scrub	scrub
scrubs	scrub
scrubbing	scrub
scuff	scuff
scuffs	scuff
scuffle	scuffle
sculpture	sculpture
sculpturer	sculpture
seal	seal
sealer	seal
sealant	seal
sealing	seal
seam	seam
seamstress	seam
search	search
searcher	search
searching	search
season	season
seasoner	season
seasoning	season
seasonableness	season
seat	seat
seats	seat
seating	seat
secession	secede
seclusion	seclude
second	second
seconder	second
secondary	second
secondment	second
section	section
sectionalism	section
sectionalisation	section
sectionalization	section
security	secure
securement	secure
secureness	secure
sedation	sedate
sedateness	sedate
sediment	sediment
sedimentation	sediment
see	see	sight
seer	see	sight
seism	see	sight
sight	see	sight
seance	see	sight
seeing	see	sight
sighting	see	sight
seed	seed
seeder	seed
seedman	seed
seek	seek
seeker	seek
seeking	seek
seepage	seep
segment	segment
segmentation	segment
segregant	segregate
segregation	segregate
seizer	seize
seizing	seize
seizure	seize
selector	select
selection	select
selectman	select
selectivity	select
sender	send
sending	send
sense	sense
sensor	sense
sensing	sense
sensation	sense
sensitizer	sense
sensitivity	sense
sensitizing	sense
sensitisation	sense
sensitiveness	sense
sensitization	sense
sentence	sentence
sentiment	sentimentalize
sentimentalist	sentimentalize
sentimentality	sentimentalize
sentimentalisation	sentimentalize
sentimentalization	sentimentalize
separate	separate
separator	separate
separation	separate
separatist	separate
separability	separate
separateness	separate
sequence	sequence
serenade	serenade
serve	serve	service
serval	serve	service
server	serve	service
servant	serve	service
service	serve	service
serving	serve	service
services	serve	service
servicing	serve	service
serviceman	serve	service
serviceability	serve	service
serviceableness	serve	service
set	set
setting	set
settle	settle
settler	settle
settling	settle
settlement	settle
several	sever
severing	sever
severity	sever
severance	sever
severality	sever
severeness	sever
sewer	sew
sewing	sew
sewerage	sew
sex	sex
sexism	sex
sexist	sex
shack	shack
shade	shade
shades	shade
shading	shade
shadiness	shade
shadow	shadow
shadowing	shadow
shaft	shaft
shag	shag
shagging	shag
shake	shake
shaker	shake
shaking	shake
shakiness	shake
shallow	shallow
shallowness	shallow
sham	sham
shame	shame
shamefulness	shame
shampoo	shampoo
shank	shank
shape	shape
shaper	shape
shaping	shape
share	share
sharer	share
sharing	share
sharpener	sharpen
shattering	shatter
shave	shave
shaver	shave
shaving	shave
shawl	shawl
shear	shear
shears	shear
shearing	shear
shed	shed
shedding	shed
sheet	sheet
sheeting	sheet
shelf	shelve
shelfful	shelve
shelving	shelve
shell	shell
shelling	shell
shelter	shelter
shepherd	shepherd
shield	shield
shielding	shield
shift	shift
shifting	shift
shilling	shill
shimmer	shimmer
shimmy	shimmy
shin	shin
shine	shine
shiner	shine
shining	shine
shininess	shine
ship	ship
shipment	ship
shipping	ship
shipwreck	shipwreck
shirt	shirt
shirting	shirt
shit	shit
shitting	shit
shiver	shiver
shivering	shiver
shock	shock
shocker	shock
shoe	shoe
shoal	shoe
shoes	shoe
shop	shop
shopping	shop
shore	shore
shoring	shore
short	short
shorts	short
shortage	short
shortness	short
shortening	shorten
shot	shoot
shoot	shoot
shooter	shoot
shooting	shoot
shoulder	shoulder
shout	shout
shouter	shout
shouting	shout
shove	shove
shovel	shovel
shoveler	shovel
shovelful	shovel
show	show
showing	show
showman	show
showiness	show
shower	shower
shred	shred
shriek	shriek
shrieking	shriek
shrilling	shrill
shrillness	shrill
shrimp	shrimp
shrine	shrine
shrink	shrink
shrinkage	shrink
shrinking	shrink
shrug	shrug
shudder	shudder
shuffle	shuffle
shuffler	shuffle
shuffling	shuffle
shunning	shun
shunt	shunt
shunter	shunt
shutting	shut
shutter	shutter
shuttle	shuttle
shy	shy
shiite	shy
shyness	shy
sick	sick
sickness	sick
side	side
siding	side
sidetrack	sidetrack
sidle	sidle
siege	siege
sieve	sieve
sigh	sigh
sign	sign	signal
signal	sign	signal
signer	sign	signal
signor	sign	signal
signing	sign	signal
signaler	sign	signal
signaling	sign	signal
signature	sign	signal
signalman	sign	signal
signaller	sign	signal
signalization	sign	signal
signification	signify
signpost	signpost
silence	silence
silencer	silence
silhouette	silhouette
silver	silver
simmer	simmer
simmering	simmer
simplification	simplify
simulator	simulate
simulation	simulate
sin	sin
sinning	sin
sinfulness	sin
sing	sing
singe	sing
singer	sing
singing	sing
single-foot	single-foot
single	single
singles	single
singleness	single
sink	sink
sinker	sink
sinkage	sink
sinking	sink
sip	sip
sipping	sip
sitting	sit
site	site
size	size
sizing	size
skate	skate
skater	skate
skates	skate
skating	skate
sketch	sketch
sketcher	sketch
skewer	skewer
ski	ski
skis	ski
skier	ski
skiing	ski
skid	skid
skin	skin
skinful	skin
skip	skip
skipper	skipper
skirmish	skirmish
skirmisher	skirmish
skirt	skirt
skulker	skulk
skulking	skulk
sky	sky
skyrocket	skyrocket
slack	slack
slacks	slack
slacker	slack
slacking	slack
slackness	slack
slam	slam
slang	slang
slant	slant
slap	slap
slash	slash
slashing	slash
slat	slat
slate	slate
slater	slate
slating	slate
slaughter	slaughter
slaughterer	slaughter
slave	slave
slavery	slave
sleekness	sleek
sleep	sleep
sleeper	sleep
sleeping	sleep
sleet	sleet
slew	slew
slews	slew
slice	slice
slicer	slice
slicing	slice
slick	slick
slickness	slick
slide	slide
slider	slide
slight	slight
slightness	slight
slimness	slim
sling	sling
slinger	sling
slinging	sling
slip	slip
slippage	slip
slipperiness	slip
slit	slit
slop	slop
slops	slop
slope	slope
slot	slot
slouch	slouch
slowing	slow
slowness	slow
slug	slug
sluice	sluice
slum	slum
slumber	slumber
slumberer	slumber
slump	slump
smack	smack
smacker	smack
smacking	smack
smart	smart
smarting	smart
smartness	smart
smash	smash
smasher	smash
smashing	smash
smear	smear
smell	smell
smelling	smell
smelt	smelt
smelter	smelt
smile	smile
smiler	smile
smiling	smile
smirk	smirk
smoke	smoke
smoker	smoke
smoking	smoke
smooth	smooth
smoother	smooth
smoothness	smooth
smuggler	smuggle
smuggling	smuggle
snack	snack
snag	snag
snail	snail
snake	snake
snap	snap
snare	snare
snatch	snatch
snatcher	snatch
sneak	sneak
sneaker	sneak
sneakiness	sneak
sneer	sneer
sneering	sneer
snick	snick
sniff	sniff
snoop	snoop
snooper	snoop
snoopiness	snoop
snort	snort
snorter	snort
snorting	snort
snow	snow
snowman	snow
snowball	snowball
soak	soak
soaker	soak
soaking	soak
soap	soap
soar	soar
soaring	soar
sobriety	sober
soberness	sober
social	socialize
socialite	socialize
socialism	socialize
socialist	socialize
sociality	socialize
socializing	socialize
socialisation	socialize
socialization	socialize
sock	sock
sod	sod
softener	soften
softening	soften
soil	soil
soilage	soil
soilure	soil
soiling	soil
sojourn	sojourn
sojourner	sojourn
solace	solace
solacement	solace
solder	solder
soldering	solder
soldier	soldier
soldiery	soldier
soldiering	soldier
soldiership	soldier
sole	sole
solicitor	solicit
solicitation	solicit
solicitousness	solicit
solo	solo
soloist	solo
solute	solve
solvate	solve
solvent	solve
solving	solve
solution	solve
solvency	solve
solvation	solve
somersault	somersault
somersaulting	somersault
sonnet	sonnet
sonneteer	sonnet
soot	soot
sooth	soothe
sop	sop
sops	sop
sophist	sophisticate
sophistry	sophisticate
sophisticate	sophisticate
sophistication	sophisticate
sorrow	sorrow
sorrowfulness	sorrow
sort	sort
sorter	sort
sorting	sort
sound	sound
sounding	sound
soundman	sound
soundness	sound
soup	soup
sour	sour
souring	sour
sourness	sour
sow	sow
sower	sow
space	space
spacing	space
spaceman	space
spaceship	space
spatiality	space
spade	spade
spadeful	spade
span	span
spangle	spangle
spare	spare
spareness	spare
spark	spark
sparkle	sparkle
sparkler	sparkle
sparkling	sparkle
spat	spat
spats	spat
spatter	spatter
spattering	spatter
speech	speak
speaker	speak
speaking	speak
spear	spear
spearhead	spearhead
special	specialise	specialize
specialty	specialise	specialize
speciality	specialise	specialize
specialism	specialise	specialize
specialist	specialise	specialize
specializer	specialise	specialize
specialness	specialise	specialize
specialisation	specialise	specialize
specialization	specialise	specialize
specific	specify
specifying	specify
specificity	specify
specification	specify
speck	speck
speculator	speculate
speculation	speculate
speculativeness	speculate
speed	speed
speeder	speed
speeding	speed
spell	spell
speller	spell
spelling	spell
spender	spend
spending	spend
spice	spice
spiciness	spice
spike	spike
spill	spill
spilth	spill
spillage	spill
spin	spin
spinal	spin
spinning	spin
spindle	spindle
spiral	spiral
spirit	spirit
spirits	spirit
spiritual	spirit
spiritualist	spirit
spirituality	spirit
spiritualism	spirit
spiritualisation	spirit
spiritualization	spirit
spirt	spirt
spit	spit
spitting	spit
spite	spite
spitefulness	spite
splash	splash
splashing	splash
splice	splice
splicer	splice
splicing	splice
splinter	splinter
splinters	splinter
splintering	splinter
split	split
splurge	splurge
spoil	spoil
spoiler	spoil
spoilage	spoil
spoiling	spoil
spoilation	spoil
sponge	sponge
sponger	sponge
sponginess	sponge
sponsor	sponsor
sponsorship	sponsor
spoof	spoof
spoon	spoon
spoonful	spoon
sport	sport
sports	sport
spot	spot
spotting	spot
spotlight	spotlight
spouse	spouse
spousal	spouse
spout	spout
sprawl	sprawl
sprawling	sprawl
spray	spray
sprayer	spray
spraying	spray
spread	spread
spreader	spread
spreading	spread
spree	spree
spring	spring
springer	spring
sprinkle	sprinkle
sprinkler	sprinkle
sprinkles	sprinkle
sprinkling	sprinkle
sprout	sprout
sprouting	sprout
spruce	spruce
spruceness	spruce
spume	spume
spur	spur
spurring	spur
spurt	spurt
sputter	sputter
sputtering	sputter
spy	spy
spying	spy
squabble	squabble
squall	squall
square	square
squareness	square
squash	squash
squat	squat
squatness	squat
squatting	squat
squawk	squawk
squawker	squawk
squeak	squeak
squeaker	squeak
squeal	squeal
squealer	squeal
squeeze	squeeze
squeezer	squeeze
squire	squire
squirrel	squirrel
squirt	squirt
stab	stab
stable	stable	stabilise	stabilize
stabile	stable	stabilise	stabilize
stabling	stable	stabilise	stabilize
stableman	stable	stabilise	stabilize
stability	stable	stabilise	stabilize
stabilizer	stable	stabilise	stabilize
stableness	stable	stabilise	stabilize
stabilisation	stable	stabilise	stabilize
stabilization	stable	stabilise	stabilize
stack	stack
stacks	stack
staff	staff
staffer	staff
stag	stag
stage	stage
stager	stage
staging	stage
stagger	stagger
staggerer	stagger
stagnation	stagnate
stain	stain
staining	stain
stake	stake
stakes	stake
staking	stake
staleness	stale
stalemate	stalemate
stall	stall
stalls	stall
stalling	stall
stallion	stall
stamp	stamp
stampede	stampede
stanchion	stanch
stand	stand	station
stance	stand	station
stands	stand	station
station	stand	station
standing	stand	station
stationer	stand	station
standoff	standoff
staple	staple
stapler	staple
star	star
starboard	starboard
starch	starch
stare	stare
start	start
starter	start
starting	start
startle	startle
starving	starve
starvation	starve
state	state
stator	state
statement	state
staunchness	staunch
stave	stave
stay	stay
stays	stay
stayer	stay
stayman	stay
steady	steady
steadiness	steady
steal	steal
stealing	steal
steam	steam
steamer	steam
steamship	steam
steel	steel
steelman	steel
steep	steep
steepness	steep
steer	steer
steering	steer
stem	stem
step	step
steps	step
stereotype	stereotype
sterility	sterilise	sterilize
sterileness	sterilise	sterilize
sterilisation	sterilise	sterilize
sterilization	sterilise	sterilize
stew	stew
stewing	stew
steward	steward
stewardship	steward
stick	stick
sticker	stick
stickiness	stick
stiffener	stiffen
stiffening	stiffen
stifle	stifle
stifling	stifle
still	still
stillness	still
stimulant	stimulate
stimulation	stimulate
sting	sting
stinger	sting
stinging	sting
stink	stink
stinker	stink
stint	stint
stipulation	stipulate
stir	stir
stirring	stir
stitch	stitch
stitcher	stitch
stitching	stitch
stock	stock
stocks	stock
stocker	stock
stockist	stock
stockman	stock
stocking	stock
stockade	stockade
stockpile	stockpile
stockpiling	stockpile
stomach	stomach
stomacher	stomach
stone	stone
stonewaller	stonewall
stonewalling	stonewall
stool	stool
stoop	stoop
stop	stop
stops	stop
stoppage	stop
stopping	stop
stopper	stopper
store	store
stores	store
storage	store
storing	store
storm	storm
straddle	straddle
straggle	straggle
straggler	straggle
strain	strain
strainer	strain
straining	strain
strand	strand
strap	strap
stratification	stratify
straw	straw
stray	stray
streak	streak
streaker	streak
stream	stream
streamer	stream
streaming	stream
streamline	streamline
streamliner	streamline
stress	stress
stretch	stretch
stretcher	stretch
stretching	stretch
stride	stride
stridor	stride
stridence	stride
stridency	stride
strife	strive
striver	strive
striving	strive
strike	strike
striker	strike
striking	strike
string	string
stringer	string
strip	strip
striper	strip
stripping	strip
stripe	stripe
stripes	stripe
striping	stripe
stroke	stroke
stroking	stroke
stroll	stroll
stroller	stroll
strengthener	strengthen
strengthening	strengthen
struggle	struggle
strut	strut
stub	stub
stucco	stucco
stud	stud
student	stud
study	study
studying	study
stuff	stuff
stuffing	stuff
stumble	stumble
stump	stump
stumper	stump
stumping	stump
stunt	stunt
stunting	stunt
style	style
stylist	style
stylite	style
stylisation	style
stylishness	style
stylization	style
sub	sub
subbing	sub
subcontract	subcontract
subcontractor	subcontract
subdue	subdue
subdual	subdue
subject	subject
subjection	subject
subjectivity	subject
subjectiveness	subject
subjugation	subjugate
sublease	sublease
sublime	sublime	sublimate
sublimate	sublime	sublimate
sublimity	sublime	sublimate
sublimation	sublime	sublimate
sublimination	sublime	sublimate
submittal	submit
submission	submit
submissive	submit
submissiveness	submit
subordinate	subordinate
subordination	subordinate
subordinateness	subordinate
subpoena	subpoena
subscribe	subscribe
subscript	subscribe
subscriber	subscribe
subcription	subscribe
subscription	subscribe
subsidy	subside	subsidize	subsidise
subsiding	subside	subsidize	subsidise
subsidence	subside	subsidize	subsidise
subsidisation	subside	subsidize	subsidise
subsidization	subside	subsidize	subsidise
subsistence	subsist
substance	substantiate
substantiation	substantiate
substantiality	substantiate
substantialness	substantiate
substitute	substitute
substituting	substitute
substitution	substitute
substitutability	substitute
subtract	subtract
subtracter	subtract
subtraction	subtract
success	succeed
successor	succeed
succession	succeed
successfulness	succeed
successiveness	succeed
succor	succor
suck	suck	suction
sucker	suck	suction
sucking	suck	suction
suction	suck	suction
suds	suds
suit	sue	suit
suite	sue	suit
suitor	sue	suit
suiting	sue	suit
sufferer	suffer
suffering	suffer
sufferance	suffer
sufficiency	suffice
suffix	suffix
suffixion	suffix
suffixation	suffix
suffusion	suffuse
sugar	sugar
suggestion	suggest
suggestibility	suggest
sulphur	sulphur
sulphuration	sulphur
sulfurisation	sulphur
sulphurization	sulphur
sum	sum	summate
summation	sum	summate
summary	summarize
summarisation	summarize
summarization	summarize
summer	summer
summons	summon	summons
summoning	summon	summons
sun	sun
sunburn	sunburn
sunderance	sunder
suntan	suntan
sup	sup
super	sup
supping	sup
superimposition	superimpose
superintendent	superintend
superintendence	superintend
supervise	supervise
supervisor	supervise
supervising	supervise
supervision	supervise
supplanter	supplant
supplanting	supplant
supplantation	supplant
supplement	supplement
supplementation	supplement
supply	supply
supplier	supply
supplies	supply
suppliant	supply
supplying	supply
support	support
supporter	support
supporting	support
supposal	suppose
supposition	suppose
suppresser	suppress
suppressor	suppress
suppression	suppress
surcease	surcease
surcession	surcease
surcharge	surcharge
surf	surf
surfer	surf
surfing	surf
surface	surface
surfacing	surface
surfeit	surfeit
surge	surge
surmise	surmise
surname	surname
surpass	surpass
surprise	surprise
surprisal	surprise
surprising	surprise
surrender	surrender
surround	surround
surrounding	surround
surroundings	surround
survey	survey
surveyor	survey
surveying	survey
survival	survive
survivor	survive
suspect	suspect
suspicion	suspect
suspense	suspend
suspender	suspend
suspension	suspend
suspenders	suspend
sustenance	sustain
sustinence	sustain
sustainment	sustain
sustainability	sustain
swallow	swallow
deglutition	swallow
swamp	swamp
swan	swan
swank	swank
swap	swap
swarm	swarm
sway	sway
swearer	swear
swearing	swear
sweat	sweat
sweats	sweat
sweater	sweat
sweating	sweat
sweep	sweep
sweeper	sweep
sweeping	sweep
sweetener	sweeten
sweetening	sweeten
swell	swell
swelling	swell
swerve	swerve
swerving	swerve
swig	swig
swim	swim
swimming	swim
swing	swing
swinger	swing
swinging	swing
swipe	swipe
swirl	swirl
switch	switch
switching	switch
switchman	switch
swivel	swivel
swoop	swoop
symbol	symbolize
symbolism	symbolize
symbolist	symbolize
symbolizing	symbolize
symbolisation	symbolize
symbolization	symbolize
sympathy	sympathise	sympathize
sympathizer	sympathise	sympathize
synchrony	synchronize
synchronism	synchronize
synchroneity	synchronize
synchronicity	synchronize
synchronising	synchronize
synchronizing	synchronize
synchronisation	synchronize
synchronization	synchronize
syndic	syndicate
syndicate	syndicate
syndicalism	syndicate
syndication	syndicate
synthetic	synthesize
synthetism	synthesize
synthesizer	synthesize
synthesisation	synthesize
synthesization	synthesize
synthetisation	synthesize
synthetization	synthesize
syringe	syringe
table	table
tableful	table
taboo	taboo
tabulator	tabulate
tabulation	tabulate
tack	tack
tacking	tack
tackle	tackle
tackler	tackle
tackling	tackle
tag	tag
tail	tail
tails	tail
tailing	tail
tailgate	tailgate
tailor	tailor
tailoring	tailor
taint	taint
take	take
taker	take
taking	take
takings	take
talc	talc
talk	talk
talks	talk
talker	talk
talking	talk
talkativeness	talk
tally	tally
tallyman	tally
tamer	tame
tameness	tame
tamp	tamp	tamper
tamper	tamp	tamper
tampering	tamp	tamper
tan	tan
tannage	tan
tangle	tangle
tanglement	tangle
tango	tango
tank	tank
tankage	tank
tankful	tank
tap	tap
taps	tap
tapping	tap
tape	tape
taping	tape
taper	taper
tapering	taper
tar	tar
target	target
tariff	tariff
tarrying	tarry
tarriance	tarry
task	task
taste	taste
taster	taste
tasting	taste
tastiness	taste
tastefulness	taste
tat	tat
tater	tat
tatting	tat
taunt	taunt
taunting	taunt
tax	tax
taxman	tax
taxation	tax
taxi	taxi
taxis	taxi
taximan	taxi
teach	teach
teacher	teach
teaching	teach
team	team
tear	tear
tears	tear
tearing	tear
tearfulness	tear
tease	tease
teaser	tease
teasing	tease
tee	tee
telegraph	telegraph
telegrapher	telegraph
telegraphist	telegraph
telephone	telephone
telephoner	telephone
telephonist	telephone
telescope	telescope
telex	telex
tell	tell
teller	tell
telling	tell
temper	temper
tempera	temper
tempering	temper
temperance	temper
temperament	temper
temperateness	temper
temporality	temporize
temporisation	temporize
temporization	temporize
tempter	tempt
temptress	tempt
temptation	tempt
tenant	tenant
tenancy	tenant
tending	tend
tendency	tend
tendance	tend
tendentiousness	tend
tender	tender
tenderizer	tender
tenderness	tender
tenderisation	tender
tenderization	tender
tense	tense
tensor	tense
tension	tense
tenseness	tense
tent	tent
tenting	tent
tenure	tenure
term	term
terms	term
termes	term
termite	term
terminal	terminate
terminator	terminate
termination	terminate
terrace	terrace
test	test
testee	test
tester	test
testing	test
testifier	testify
testification	testify
texture	texture
thanks	thank
thanking	thank
thankfulness	thank
thaw	thaw
thawing	thaw
theory	theorize
theorist	theorize
theorization	theorize
theorisation	theorize
thermostat	thermostat
thermostatics	thermostat
thickener	thicken
thickening	thicken
thinness	thin
thinning	thin
think	think
thought	think
thinker	think
thinking	think
thoughtfulness	think
thirst	thirst
thrash	thrash
thrasher	thrash
thrashing	thrash
thread	thread
threads	thread
threat	threaten
thrill	thrill
thriller	thrill
throne	throne
throng	throng
throttle	throttle
throttling	throttle
throw	throw
thrower	throw
thrust	thrust
thruster	thrust
thrusting	thrust
thud	thud
thumb	thumb
thump	thump
thumping	thump
thunder	thunder
thunderer	thunder
thunk	thunk
thwack	thwack
thwart	thwart
thwarting	thwart
tick	tick
ticker	tick
ticking	tick
ticket	ticket
tide	tide
tiding	tide
tidings	tide
tidy	tidy
tidiness	tidy
tie	tie	tying
tier	tie	tying
tying	tie	tying
tightening	tighten
tile	tile
tiling	tile
till	till	tiller
tiller	till	tiller
tillage	till	tiller
tilling	till	tiller
tilt	tilt
time	time
timer	time
times	time
timing	time
timetable	timetable
tin	tin
tinful	tin
tinning	tin
tincture	tincture
tinker	tinker
tinsel	tinsel
tint	tint
tinting	tint
tip	tip
tipple	tipple
tippler	tipple
tire	tire
tiresomeness	tire
tissue	tissue
title	title
titter	titter
toe	toe
toast	toast
toaster	toast
toasting	toast
toil	toil
toiler	toil
toilsomeness	toil
tolerance	tolerate
toleration	tolerate
tolerability	tolerate
toll	toll
toller	toll
tollman	toll
tone	tone
tongue	tongue
tool	tool
top	top
topee	top
toper	top
topping	top
topple	topple
torch	torch
torment	torment
tormenter	torment
tormentor	torment
torpedo	torpedo
torture	torture
torturer	torture
torturing	torture
toss	toss
total	total
totalism	total
totality	total
totaliser	total
totalizer	total
totalisator	total
totalisation	total
totalitarian	total
totalization	total
totalitarianism	total
tote	tote
toter	tote
touch	touch
touching	touch
touchdown	touchdown
tour	tour
tourer	tour
tourism	tour
touring	tour
tourist	tour
tout	tout
tow	tow
towel	towel
toweling	towel
towelling	towel
tower	tower
toy	toy
toying	toy
trace	trace
tracer	trace
tracery	trace
tracing	trace
traction	trace
track	track
tracker	track
tracking	track
trade	trade
trader	trade
trading	trade
traffic	traffic
trafficker	traffic
trafficator	traffic
trail	trail
trailer	trail
trailing	trail
train	train
trainee	train
trainer	train
trainful	train
training	train
trainman	train
trammel	trammel
trammels	trammel
tramp	tramp
trample	trample
trampling	trample
trance	trance
transparent	transparent
transparence	transparent
transparency	transparent
transparentness	transparent
transact	transact
transaction	transact
transactions	transact
transcendence	transcend
transcendency	transcend
trandscendence	transcend
transcendentalism	transcend
transcript	transcribe
transcription	transcribe
transfer	transfer
transferral	transfer
transference	transfer
transferability	transfer
transform	transform
transformer	transform
transformation	transform
transit	transit
transition	transit
transitivity	transit
transitiveness	transit
translator	translate
translation	translate
transmittal	transmit
transmitter	transmit
transmission	transmit
transmitting	transmit
transmittance	transmit
transpiration	transpire
transplant	transplant
transplanting	transplant
transplantation	transplant
transponder	transponder
transport	transport
transporter	transport
transportation	transport
transverse	transverse
transversal	transverse
trap	trap
trapping	trap
trappings	trap
trash	trash
travel	travel
traveler	travel
traveling	travel
traveller	travel
travelling	travel
traverse	traverse
traversal	traverse
travesty	travesty
tread	tread
treasure	treasure
treasurer	treasure
treat	treat
treatment	treat
treble	treble
tree	tree
trek	trek
tremble	tremble
trembles	tremble
trembling	tremble
tremor	tremor
trench	trench
trencher	trench
trend	trend
trespass	trespass
trespasser	trespass
triangle	triangle
trick	trick
trickery	trick
trickle	trickle
trifle	trifle
trifling	trifle
trigger	trigger
trill	trill
trillion	trill
trillions	trill
trim	trim
trimer	trim
trimming	trim
trimness	trim
trip	trip
triple	triple
tripling	triple
triumph	triumph
trolley	trolley
troop	troop
troops	troop
trooper	troop
troopship	troop
trot	trot
trouble	trouble
troubling	trouble
troublesomeness	trouble
truant	truant
truancy	truant
truck	truck
truckful	truck
trucking	truck
true	true
truth	true
truthfulness	true
trump	trump
trumping	trump
trumpet	trumpet
trumpets	trumpet
trumpeter	trumpet
trundle	trundle
trust	trust
trustee	trust
trustfulness	trust
try	try
trial	try
trier	try
tryst	try
tube	tube
tubing	tube
tuck	tuck
tucker	tuck
tug	tug
tumble	tumble
tumbler	tumble
tumbling	tumble
tune	tune
tuner	tune
tuning	tune
tunefulness	tune
tunnel	tunnel
turf	turf
turn	turn
turner	turn
turnery	turn
turning	turn
tussle	tussle
tutor	tutor
tutelage	tutor
tutorial	tutor
tutoring	tutor
tutorship	tutor
twin	twin
twinge	twinge
twinkle	twinkle
twinkling	twinkle
twist	twist
twister	twist
twisting	twist
twitch	twitch
twitching	twitch
type	type	typify
typing	type	typify
typist	type	typify
typifying	type	typify
typicality	type	typify
typification	type	typify
tyranni	tyrannize
tyranny	tyrannize
ultracentrifuge	ultracentrifuge
ultracentrifugation	ultracentrifuge
umpire	umpire
umpirage	umpire
umpiring	umpire
umpireship	umpire
unbalance	unbalance
uncovering	uncover
undercut	undercut
underestimate	underestimate
underestimation	underestimate
underline	underline
underpin	underpin
underpinning	underpin
underrating	underrate
underscore	underscore
understand	understand
understanding	understand
understandability	understand
understatement	understate
undertaker	undertake
undertaking	undertake
underwriter	underwrite
undoing	undo
unearth	unearth
unfitness	unfit
unfolding	unfold
uniform	uniform
uniformity	uniform
uniformness	uniform
unification	unify
unit	unite
union	unite
unity	unite
uniting	unite
unionism	unite
unionist	unite
unitarian	unite
unionisation	unite
unionization	unite
unitarianism	unite
universe	universe	universalize
universal	universe	universalize
university	universe	universalize
universalism	universe	universalize
universality	universe	universalize
universalisation	universe	universalize
universalization	universe	universalize
unlike	unlike
unlikeness	unlike
unloading	unload
unravelment	unravel
unsettlement	unsettle
untying	untie
unveiling	unveil
update	update
updating	update
upgrade	upgrade
uplift	uplift
uplifting	uplift
upliftment	uplift
upright	upright
uprightness	upright
upset	upset
upswing	upswing
urge	urge
urging	urge
urgency	urge
us	use
use	use
user	use
using	use
usance	use
usefulness	use
usher	usher
usurper	usurp
usurpation	usurp
utility	utilize
utilitarian	utilize
utilisation	utilize
utilization	utilize
utilitarianism	utilize
utterance	utter
vacation	vacate	vacation
vacationer	vacate	vacation
vacationing	vacate	vacation
vacationist	vacate	vacation
vaccine	vaccinate
vaccinating	vaccinate
vaccination	vaccinate
vacuum	vacuum
vagabond	vagabond
valet	valet
validity	validate
validness	validate
validation	validate
validating	validate
value	value
valuer	value
values	value
valuator	value
valuation	value
vanishing	vanish
vanishment	vanish
vapor	vapor
vaporing	vapor
vaporisation	vapor
vaporization	vapor
varnish	varnish
variant	vary
variate	vary
variable	vary
variance	vary
variation	vary
variability	vary
variational	vary
variableness	vary
vault	vault
vaulter	vault
vaulting	vault
vector	vector
veering	veer
veil	veil
veiling	veil
vein	vein
veneer	veneer
veneering	veneer
avenger	avenge
vengeance	avenge
vengefulness	avenge
vent	vent
venter	vent
venting	vent
venture	venture
venturesomeness	venture
verge	verge
verification	verify
vermilion	vermilion
verse	verse
vest	vest
vesta	vest
vestal	vest
vestment	vest
vet	vet
veto	veto
vexation	vex
victim	victimize
victimisation	victimize
victimization	victimize
vial	vying
view	view
viewer	view
viewers	view
viewing	view
vignette	vignette
vindicator	vindicate
vindication	vindicate
violator	violate
violation	violate
violability	violate
visa	visa
visit	visit
visitor	visit
visitant	visit
visiting	visit
visitation	visit
visualizer	visual	visualize
visualisation	visual	visualize
visualization	visual	visualize
vivifying	vivify
vivification	vivify
vocal	vocalize
vocalist	vocalize
vocalizing	vocalize
vocalisation	vocalize
vocalization	vocalize
voice	voice
void	void
voiding	void
voidance	void
volley	volley
volunteer	volunteer
voodoo	voodoo
vote	vote
voter	vote
voting	vote
vow	vow
voyage	voyage
voyager	voyage
wader	wade
wading	wade
wage	wage
wages	wage
wager	wager
wagerer	wager
wail	wail
wailing	wail
wait	wait	await
waiter	wait	await
waiting	wait	await
waitress	wait	await
waiver	waive
wake	wake
waking	wake
wakefulness	wake
walk	walk
walker	walk
walking	walk
wall	wall
wallop	wallop
walloping	wallop
wallow	wallow
wallpaper	wallpaper
waltz	waltz
wan	wan	wane
wane	wan	wane
waning	wan	wane
wanness	wan	wane
wander	wander
wanderer	wander
wandering	wander
want	want
wanton	wanton
wantonness	wanton
war	war
warship	war
ward	ward
ware	ware
wares	ware
warehouse	warehouse
warehouser	warehouse
warm	warm
warmth	warm
warmer	warm
warming	warm
warmness	warm
warning	warn
warp	warp
warping	warp
warrant	warrant
warrantee	warrant
warrantor	warrant
wash	wash
washer	wash
washing	wash
waste	waste
waster	waste
wasting	waste
wastefulness	waste
watch	watch
watcher	watch
watchman	watch
watching	watch
watchfulness	watch
water-skiing	water-ski
water	water
waters	water
watering	water
waterman	water
watercolor	watercolor
waterproof	waterproof
waterproofing	waterproof
wave	wave
waving	wave
waver	waver
waverer	waver
wavering	waver
wax	wax
waxing	wax
weakening	weaken
weaning	wean
wear	wear
wearer	wear
wearing	wear
weariness	weary
weasel	weasel
weather	weather
weatherman	weather
weave	weave
weaver	weave
weaving	weave
web	web
webbing	web
wed	wed
wedding	wed
wedge	wedge
wee	wee
weal	wee
west	wee
weeness	wee
weed	weed
weeds	weed
weekend	weekend
weekender	weekend
weeper	weep
weeping	weep
weepiness	weep
weight	weigh	weight
weighing	weigh	weight
weighting	weigh	weight
welcome	welcome
welcoming	welcome
weld	weld
welder	weld
welding	weld
weldment	weld
well	well
welter	welter
wet	wet
wetness	wet
wetting	wet
whack	whack
whacker	whack
whacking	whack
whale	whale
wheel	wheel
wheels	wheel
wheeler	wheel
wheeling	wheel
whiff	whiff
while	while
whimper	whimper
whimpering	whimper
whine	whine
whiner	whine
whinny	whinny
whip	whip
whipping	whip
whir	whir
whirring	whir
whirl	whirl
whirling	whirl
whisper	whisper
whisperer	whisper
whispering	whisper
whistle	whistle
whistler	whistle
whistling	whistle
white	white
whiting	white
whiteness	white
whiz	whiz
whizz	whiz
wholesale	wholesale
wholesaler	wholesale
whoop	whoop
whoopee	whoop
whooper	whoop
whoosh	whoosh
whore	whore
whoredom	whore
widening	widen
widow	widow
widower	widow
wig	wig
wigging	wig
wiggle	wiggle
wiggler	wiggle
wiggliness	wiggle
wildcat	wildcat
wildcatting	wildcat
will	will
willing	will
willfulness	will
wilt	wilt
wilting	wilt
win	win
winning	win
winnings	win
winsomeness	win
wind	wind
winder	wind
winding	wind
wine	wine
winery	wine
winemaker	wine
winemaking	wine
wing	wing
wings	wing
winger	wing
wingman	wing
wink	wink
winker	wink
winnow	winnow
winnowing	winnow
winter	winter
winterisation	winter
winterization	winter
wipe	wipe
wiper	wipe
wire	wire
wiring	wire
wish	wish
wishing	wish
wishfulness	wish
wit	wit	witness
witness	wit	witness
witch	witch
witchery	witch
withdrawal	withdraw
withdrawnness	withdraw
withers	wither
withering	wither
withholding	withhold
wobble	wobble
wobbler	wobble
wolf	wolf
wolfman	wolf
wonder	wonder
wonderment	wonder
wonderfulness	wonder
wont	wont
wooer	woo
wooing	woo
woolgatherer	woolgather
woolgathering	woolgather
word	word
words	word
wording	word
work	work
works	work
worker	work
workman	work
working	work
workings	work
worm	worm
worry	worry
worrier	worry
worrying	worry
worriment	worry
worsening	worsen
worship	worship
worshiper	worship
worst	worst
worsted	worst
wound	wound
wounded	wound
wounding	wound
wrack	wrack
wrangle	wrangle
wrangler	wrangle
wrangling	wrangle
wrap	wrap
wrapping	wrap
wreath	wreath
wreck	wreck
wrecker	wreck
wrecking	wreck
wrench	wrench
wrest	wrest
wrestle	wrestle
wrestler	wrestle
wrestling	wrestle
wring	wring
wringer	wring
wrinkle	wrinkle
writer	write
writing	write
writings	write
writhe	writhe
wrong	wrong
wrongdoer	wrong
wrongness	wrong
wrongdoing	wrong
wrongfulness	wrong
x-raying	x-ray
yacht	yacht
yachting	yacht
yank	yank
yankee	yank
yarn	yarn
yawl	yawl
yawn	yawn
yearning	yearn
yell	yell
yeller	yell
yelling	yell
yellow	yellow
yellowness	yellow
yelp	yelp
yelping	yelp
yen	yen
yield	yield
yielding	yield
yip	yip
yodel	yodel
yodeling	yodel
yodeller	yodel
yoke	yoke
zero	zero
zest	zest
zestfulness	zest
zing	zing
zip	zip
zipper	zipper
zone	zone
zoning	zone
>>> 
